channel_name	channel_code	alias_name
电视指南	dszn	电视指南/中数传媒电视指南/cctv电视指南/中央电视台电视指南/中央电视指南频道/中央电视指南/cctv电视指南频道/广电电视指南/数字指南/中数电视指南/央视指南
内蒙古卫视	nmg_ws	内蒙卫视/内蒙古卫视/内蒙卫视频道/内蒙卫星电视/内蒙卫星频道/内蒙卫星/内蒙古电视台/内蒙古电视/内蒙古汉语卫视/内蒙台/内蒙/内蒙古台/内蒙古/内蒙电视台/波浪台/内蒙古tv/内蒙tv/内蒙电视
云南卫视	yn_ws	云南卫视/云南卫视频道/云南卫星电视/云南卫星频道/云南卫星/孔雀台/孔雀/yntv1/云南电视台卫星频道/云南电视台卫星/云南电视台/云南电视/云南台/云南/云南tv
深圳卫视高清	sz_ws	深圳卫视高清/深圳高清
广东卫视高清	gd_ws_hd	广东卫视高清/广东高清
北京卫视高清	bj_ws_hd	北京卫视高清/北京高清
北京体育高清	bj_ty_hd	北京体育高清/btv体育高清
CCTV1	cctv1	cctv1综合/中央电视台综合频道/中央电视台综合/cctv1/中央电视台一套/中央电视台一/央视一套/央视一/cctv一套/cctv一/中央综合频道/中央综合/央视综合频道/央视综合/中央一套/中央一/中央1套/中央1/央视1台/央视1/中央一台/中央1台/cctv1电视台/cctv1电视/cctv1频道/cctv1台/cctv1套/cctv一台/cctv综合频道/cctv综合/央视1频道/央视1套/央视一台/中央1频道/中央电视台1/中央电视台1频道/中央电视台1套/中央台一套/中央台一/中央台综合频/中央电视台/中央电视/中央卫视1频道/中央卫视一套/中央卫视综合/中央卫视1套/中央卫视1台/中央卫视一台/央视台/中央台/cctv电视台/cctvtv/cctv电视/中央tv/央视电视台/央视tv/央视电视/中央电视一台
CCTV2	cctv2	cctv2财经/中央电视台财经频道/中央电视台财经/cctv2/央视二套/央视二/中央电视台二套/中央电视台二/央视2套/央视2/中央经济频道/中央经济/央视经济频道/央视经济/中央二套/中央二/中央2套/中央2/中央二台/中央2台/cctv经济频道/cctv经济/cctv2频道/cctv财经频道/cctv财经/cctv2套/央视2频道/央视2台/央视二台/央视财经频道/央视财经/中央财经频道/中央财经/中央电视台2/中央电视台2频道/中央电视台2套/中央台2套/中央台2/中央电视台2财经/中央卫视2频道/中央卫视二套/中央卫视财经/中央卫视2套/中央卫视2台/中央卫视二台/cctv二
CCTV3	cctv3	cctv3综艺/中央电视台综艺频道/中央电视台综艺/cctv3/中央三套/中央三/中央电视台三套/中央电视台三/央视三套/央视三/中央3套/中央3/央视3套/央视3/中央电视台3套/中央电视台3/中央台综艺频道/中央台综艺/央视综艺频道/央视综艺/中央3台/中央三台/cctv综艺频道/cctv综艺/cctv3套/cctv3台/央视3频道/央视3台/央视三台/中央3频道/中央电视台3频道/中央电视台3综艺/中央卫视3频道/中央卫视三套/中央卫视综艺/中央卫视3套/中央卫视3台/中央卫视三台/cctv三
CCTV4	cctv4	cctv4国际/中央电视台中文国际频道/中央电视台中文国际/cctv4/央视国际/中央4套/中央4/央视4套/央视4/中央电视台4套/中央电视台4/中央四套/中央四/央视四套/央视四/央视国际频道/中央国际频道/中央国际/中央4台/中央四台/cctv4亚洲/cctv4亚洲台/cctv4亚洲频道/cctv国际频道/cctv国际/央视4频道/央视4台/央视四台/中央4频道/中央电视台4频道/中央电视台cctv4/cctv亚洲台/cctv亚洲/cctv4中文国际/中央卫视4频道/中央卫视四套/中央卫视国际/中央卫视4套/中央卫视4台/中央卫视四台/cctv中文国际/cctv中文国际频道/央视中文国际频道/cctv四/中央电视台四/国际新闻频道
CCTV5	cctv5	cctv5体育/中央电视台体育频道/中央电视台体育/cctv5/央视体育/中央5套/中央5/中央五套/中央五/中央电视台五套/中央电视台五/cctv体育频道/cctv体育/中央体育频道/中央体育/央视体育频道/央视五套/央视五/中央5台/中央五台/cctv奥运/cctv5电视台/cctv5电视/cctv5频道/cctv5台/cctv5套/cctv5体育频道/央视5/央视5频道/央视5台/央视5套/央视五台/中央5频道/中央5套体育频道/中央5套体育/中央5台体育频道/中央5台体育/中央卫视5频道/中央卫视五套/中央卫视体育/中央卫视5套/中央卫视5台/中央卫视五台/cctv五/中央电视台5
CCTV6	cctv6	cctv电影/中数传媒家庭影院/cctv电影台/cctv电影频道/电影付费频道/电影付费/cctv6电影/中央电视台电影频道/中央电视台电影/cctv6/央视电影/央视6套/央视6/中央6套/中央6/中央六套/中央六/央视六套/央视六/中央六台/中央6台/电影频道/电影/cctv6本周/cctv6电视剧/cctv6频道/cctv6直播/cctv影视/央视6频道/央视6台/中央电影频道/中央电影/中央卫视6频道/中央卫视六套/中央卫视电影/中央卫视6套/中央卫视6台/中央卫视六台/央视六台/央视电影频道/cctv六
CCTV7	cctv7	cctv7军事/中央电视台军事农业频道/中央电视台军事农业/cctv7/cctv7农业频道/cctv7农业/中央七套/中央七/央视七套/央视七/中央农业频道/中央农业/央视农业频道/央视农业/中央七台/中央7套/中央7/cctv军事频道/cctv军事/央视7频道/央视7/央视7台/央视7套/央视军事频道/央视军事/央视七台/中央7频道/中央7台/中央电视台7/中央电视台7频道/中央电视台7套/cctv军事农业频道/cctv军事农业/cctv7军事农业/中央卫视7频道/中央卫视七套/中央卫视农业/中央卫视军事/中央卫视7套/中央卫视7台/中央卫视七台/cctv农业军事/cctv农业军事频道/央视农业军事频道/cctv农业/cctv农业频道/耕战台/cctv七/中央电视台七
CCTV8	cctv8	cctv8电视剧/中央电视台电视剧频道/中央电视台电视剧/cctv8/中央电视剧频道/中央电视剧/中央八套/中央八/央视八套/央视八/央视电视剧频道/央视电视剧/中央8套/中央8/中央8台/中央八台/cctv电视剧频道/cctv电视剧/央视8频道/央视8/央视8台/央视8套/央视八台/中央8频道/中央电视台8/中央电视台8频道/中央电视台8套/中央台电视剧/电视剧频道/电视剧/中央卫视8频道/中央卫视八套/中央卫视电视剧/中央卫视8套/中央卫视8台/中央卫视八台/cctv八/中央电视台八
CCTV9	cctv9	cctv9纪录/中央电视台纪录频道/中央电视台纪录/cctv9/中央九套/中央九/央视九套/央视九/中央电视台九套/中央电视台九/中央9套/中央9/中央九台/央视9套/央视9/cctv纪录频道/cctv纪录/央视9频道/央视9台/中央9纪录频道/中央9纪录/中央9台/中央9台纪录频道/中央9台纪录/中央9套纪录频道/中央9套纪录/中央电视台9频道/中央电视台9/纪录频道/纪录/cctv纪录片频道/cctv纪录片/央视九台/cctv9记录频道/cctv9记录/中央卫视9频道/中央卫视九套/中央卫视记录/中央卫视9套/中央卫视9台/中央卫视九台/cctv记录/cctv记录频道/央视记录频道/cctv九
CCTV10	cctv10	cctv10科教/中央电视台科教频道/中央电视台科教/cctv10/中央科教频道/中央科教/央视科教频道/央视科教/cctv科教频道/cctv科教/中央10套/中央10/中央十套/中央十/中央10台/中央十台/央视十台/央视十/央视10套/央视10/央视10台/cctv10频道/cctv10套/央视10频道/央视十套/中央10频道/中央电视台10/中央电视台10频道/中央电视台10套/中央台10套/中央台10/中央台科教频道/中央台科教/中央台十套/中央台十/ctv10科教/中央卫视10频道/中央卫视十套/中央卫视科技/中央卫视10套/中央卫视10台/中央卫视十台/中央教育台/cctv十/中央电视台十
CCTV11	cctv11	cctv戏曲/中数传媒央视戏曲/戏曲频道/戏曲/cctv11戏曲/中央电视台戏曲频道/中央电视台戏曲/cctv11/央视11套/央视11/中央11套/中央11/央视戏曲/中央戏曲频道/中央戏曲/央视戏曲频道/中央十一套/中央十一/中央十一台/中央11台/cctv11频道/cctv11套/cctv戏曲频道/央视11频道/央视11台/中央11频道/中央电视台11/中央电视台11频道/中央电视台11套/中央台11套/中央台11/中央台戏曲频道/中央台戏曲/中央卫视11频道/中央卫视十一套/中央卫视戏曲/中央卫视11套/中央卫视11台/中央卫视十一台/央视十一套/央视十一台/cctv十一/中央电视台十一
CCTV12	cctv12	cctv12法制/中央电视台法制频道/中央电视台法制/cctv12/央视12套/央视12/中央12套/中央12/央视法制频道/央视法制/中央法制频道/中央法制/中央12台/中央十二台/中央十二/cctv12频道/cctv12套/cctv法制频道/cctv法制/央视12频道/央视12台/中央12频道/中央电视台12/中央电视台12频道/中央电视台12套/中央十二套/中央台12套/中央台12/中央台法制频道/中央台法制/cctv12社会与法/中央卫视12频道/中央卫视十二套/中央卫视法制/中央卫视12套/中央卫视12台/中央卫视十二台/央视十二套/央视十二台/cctv社会与法/cctv社会与法频道/央视社会与法频道/cctv十二/中央电视台十二/cctv社会与法制
CCTV13	cctv13	cctv13新闻/中央电视台新闻频道/中央电视台新闻/cctv13/cctv新闻/央视新闻/cctv新闻台/中央新闻频道/中央新闻/央视新闻频道/中央13台/中央13/中央13套/cctv新闻频道/央视十三套/央视十三/央视新闻台/中央新闻台/中国中央电视台新闻频道/中国中央电视台新闻/中央電視台新聞/中央十三台/中央十三/cctvnews/中央卫视13频道/中央卫视十三套/中央卫视新闻/中央卫视13套/中央卫视13台/中央卫视十三台/中央十三套/央视十三台/cctv十三
CCTV14	cctv14	cctv14少儿/中央电视台少儿频道/中央电视台少儿/cctv14/央视少儿/中央少儿/cctv少儿频道/cctv少儿/中央少儿频道/央视少儿频道/中央14套/中央14/cctv14套/央视14套/央视14/cctv少儿台/少儿台/少儿/央视十四套/央视十四/中央电视台14套/中央电视台14/中央14台/中央卫视14频道/中央卫视十四套/中央卫视少儿合/中央卫视14套/中央卫视14台/中央卫视十四台/中央十四套/中央十四台/中央十四/央视十四台/cctv十四/中央电视台十四
CCTV15	cctv15	cctv15音乐/中央电视台音乐频道/中央电视台音乐/cctv15/cctv音乐/cctv音乐台/中央音乐频道/中央音乐/中央电视台15套/中央电视台15/央视十五套/央视十五/cctv音乐频道/央视音乐频道/央视音乐/中央15台/中央15/cctv15套/中央15套/中国音乐频道/中国音乐/cctv15（音乐）/音乐/中央卫视15频道/中央卫视十五套/中央卫视音乐/中央卫视15套/中央卫视15台/中央卫视十五台/中央十五套/中央十五台/中央十五/央视十五台/cctv十五/中央电视台十五
北京卫视	bj_ws	北京卫视/btv1/btv1台/btv1套/北京1台/北京1/北京电视台一套/北京电视台一/北京卫视频道/北京卫视台/北京卫星电视/北京一台/北京一/北京一套/btv北京/btv北京卫视/btv卫视/北京电视台/北京电视/北京台/北京tv
CETV1	cetv1	教育1台/教育1/中国教育电视台一套/中国教育电视台一/cetv1/教育台1频道/教育台1/教育台一频道/教育台一/中国教育1台/中国教育1/中国教育电视1台/中国教育电视1/中国教育电视台1套/中国教育电视台1/中国教育台1/中国教育台1套/中央教育1台/中央教育1/中央教育一台/中央教育一/cetv中国教育1/中国教育/中国教育一/中国教育一台/中教一台/中教一/中央教育一套/中央教育/中教一套/中国教育台/中央
CETV2	cetv2	教育2台/教育2/中国教育电视台二套/中国教育电视台二/cetv2/教育台2频道/教育台2/教育台二频道/教育台二/中国教育2台/中国教育2/中国教育电视2台/中国教育电视2/中国教育电视台2套/中国教育电视台2/中国教育台2/中国教育台2套/中央教育2台/中央教育2/中国教育二台/中国教育二/中央教育二套/中央教育二/中教二套/中教二/中教2台/中教2/中国教育二套/教育二台/教育二
CETV3	cetv3	教育3台/教育3/中国教育电视台三套/中国教育电视台三/教育台3频道/教育台3/教育台三频道/教育台三/中国教育3台/中国教育3/中国教育电视3台/中国教育电视3/中国教育电视台3套/中国教育电视台3/中国教育台3/中国教育台3套/中央教育3台/中央教育3/中国教育三/中央教育三套/中央教育三/中教3台/中教3/cetv3/教育三台/教育三
CETV4	cetv4	空中课堂/cetv4/教育台4频道/教育台4/教育台四频道/教育台四/中国教育4台/中国教育4/中国教育电视4台/中国教育电视4/中国教育电视台4套/中国教育电视台4/中国教育台4/中国教育台4套/中央教育4台/中央教育4/空中课堂文献纪录/cetv空中课堂/空中教室/教育四台/教育四
CETV5	cetv5	cetv5/教育5台/教育5/教育五台/教育五
CETV6	cetv6	cetv6/教育6台/教育6/教育六台/教育六
CETV7	cetv7	cetv7/教育7台/教育7/教育七台/教育七
CETV8	cetv8	cetv8/教育8台/教育8/教育八台/教育八
CETV9	cetv9	cetv9/教育9台/教育9/教育九台/教育九
CETV10	cetv10	cetv10/教育10台/教育10/教育十台/教育十
北京文艺	bj_wy	北京文艺频道/北京文艺/北京电视台文艺频道/北京电视台文艺/btv2/btv2套/btv文艺频道/btv文艺/btv文艺台/北京2台/北京2/北京2套/北京电视台二套/北京电视台二/北京二台/北京二/北京二套/北京台文艺频道/北京台文艺/北京文艺台
北京体育	bj_ty	北京体育频道/北京体育/北京电视台体育频道/北京电视台体育/btv6/btv6台/btv6套/btv6体育/btv体育/btv体育频道/北京6台/北京6/北京电视台六套/北京电视台六/北京六台/北京六/北京六套/北京台体育频道/北京台体育/北京体育台
北京新闻	bj_xw	北京新闻频道/北京新闻/北京电视台新闻频道/北京电视台新闻/btv9/btv9台/btv9套/btv公共频道/btv公共/北京电视台九套/北京电视台九/北京九台/北京九/北京九套/北京台公共频道/北京台公共/btv9公共新闻/btv新闻/北京公共频道/北京公共
安徽卫视高清	ah_ws_hd	安徽卫视高清/安徽高清
东南卫视高清	dn_ws_hd	东南卫视高清
CCTV1高清	cctv1_hd	cctv1高清/综合高清/中央综合高清/央视综合高清/综合频道hd/综合频道高清/中央一台高清/中央1高清/中央一高清
CCTV2高清	cctv2_hd	cctv2高清/财经高清/中央财经高清/央视财经高清/中央2高清/中央二高清
CCTV3高清	cctv3_hd	cctv3高清/综艺高清/中央综艺高清/央视综艺高清/中央3高清/中央三高清
CCTV4高清	cctv4_hd	cctv4高清/中文国际高清/中央四台高清/中央四高清/中央4高清
CCTV5高清	cctv5_hd	cctv5高清/体育高清/中央体育高清/央视体育高清/中央五高清/中央5高清
CCTV6高清	cctv6_hd	cctv6高清/电影高清/中央电影高清/央视电影高清/中央六高清/中央6高清
CCTV7高清	cctv7_hd	cctv7高清/军事高清/农业高清/中央军事高清/央视军事高清/中央农业高清/央视农业高清/中央7高清/中央七高清
CCTV8高清	cctv8_hd	cctv8高清/电视剧高清/中央电视剧高清/央视电视剧高清/中央8高清/中央八高清
CCTV9高清	cctv9_hd	cctv9高清/记录高清/中央记录高清/央视记录高清/中央9高清/中央九高清
CCTV10高清	cctv10_hd	cctv10高清/科教高清/中央科教高清/央视科教高清/中央10高清/中央十高清
CCTV11高清	cctv11_hd	cctv11高清/戏曲高清/中央戏曲高清/央视戏曲高清/中央11高清/中央十一高清
CCTV12高清	cctv12_hd	cctv12高清/社会与法高清/社会高清/法律高清/中央社会高清/中央法律高清/央视社会高清/央视法律高清/中央12高清/中央十二高清
CCTV13高清	cctv13_hd	cctv13高清/新闻高清/中央新闻高清/央视新闻高清/中央13高清/中央十三高清
CCTV14高清	cctv14_hd	cctv14高清/少儿高清/中央少儿高清/央视少儿高清/中央14高清/中央十四高清
CCTV15高清	cctv15_hd	cctv15高清/音乐高清/中央音乐高清/央视音乐高清/中央15高清/中央十五高清
湖南卫视高清	hunan_ws_h	湖南卫视高清/湖南高清
3D高清	3d_hd	3d高清
辽宁卫视高清	ln_ws_hd	辽宁卫视高清/辽宁高清
重庆卫视高清	cq_ws_hd	重庆卫视高清/重庆高清
黑龙江卫视高清	hlj_ws_hd	黑龙江卫视高清/黑龙江高清
山东卫视高清	sd_ws_hd	山东卫视高清/山东高清
天津卫视高清	tj_ws_hd	天津卫视高清/天津高清
湖北卫视高清	hubei_ws_h	湖北卫视高清/湖北高清
江苏卫视高清	js_ws_hd	江苏卫视高清/江苏高清
数据广播	sj_gb	数据广播
音像世界	yinxiangsh	音像世界
世界地理	shijiedili	世界地理/cctv世界地理/中数传媒世界地理/世界地理频道/中央电视台世界地理频道/中央电视台世界地理/中央世界地理频道/中央世界地理/世界地理台/中央世界地理台
新视觉高清	xinshijue_	新视觉高清
都市剧场高清	doushi_jc_	都市剧场高清/都市剧场hd
幸福彩高清	yingfucai_	幸福彩高清/幸福彩hd
生活时尚高清	shenghuosh	生活时尚高清/生活时尚hd
动漫秀场高清	dongmanxiu	动漫秀场高清/动漫秀场hd
求索科学	qiusuo_kx	求索科学/华数求索科学频道/华数求索科学
求索纪录	qiusuo_jl	求索纪录/华数求索纪录频道/华数求索纪录/求索记录/华数求索记录
求索动物	qiusuo_dw	求索动物/华数求索动物频道/华数求索动物
求索生活	qiusuo_sh	求索生活/华数求索生活频道/华数求索生活
北京纪实高清	beijingjis	北京纪实高清
凤凰卫视中文高清	fh_ws_zw_h	凤凰卫视中文高清
凤凰卫视资讯高清	hf_ws_zx_h	凤凰卫视资讯高清
茶频道	tee	茶频道/茶/中数传媒先锋纪录/湖南先锋纪录频道/湖南先锋纪录/vbs先锋纪录频道/vbs先锋纪录/先锋记录频道/先锋记录/先锋纪录频道/先锋纪录/湖南先锋纪录台
快乐垂钓	kuailechui	快乐垂钓/vbs快乐垂钓频道/vbs快乐垂钓/快乐垂钓频道/湖南电视台快乐垂钓频道/湖南电视台快乐垂钓/湖南快乐垂钓频道/湖南快乐垂钓
先锋乒羽	xianfengbi	先锋乒羽/乒羽先锋/湖南先锋乒羽频道/湖南先锋乒羽/van先锋乒羽频道/van先锋乒羽/先锋乒羽van/乒羽频道/乒羽/先锋兵羽/羽频道/羽
湖南卫视国际	hn_ws_gj	湖南国际频道/湖南国际/湖南电视台国际频道(亚洲）/湖南台国际频道/湖南台国际/湖南国际台/湖南卫视国际
湖南时尚	hn_ss	湖南时尚频道/湖南时尚/湖南电视台时尚频道/湖南电视台时尚/湖南时尚购物频道/湖南时尚购物
凤凰电影	ifeng_dy	凤凰卫视电影台/凤凰卫视电影/凤凰电影台/凤凰电影
凤凰中文	ifeng_zw	凤凰卫视/凤凰卫视中文台/凤凰卫视中文/凤凰卫视频道/凤凰卫星电视/凤凰卫星频道/凤凰卫星/凤凰中文台/凤凰中文/凤凰电视台/凤凰电视/风凰中文台/风凰中文/phoenix/凤凰tv
凤凰资讯	ifeng_zx	凤凰卫视资讯台/凤凰卫视资讯/凤凰资讯台/凤凰资讯/香港凤凰卫视资讯台/香港凤凰卫视资讯/资讯台/资讯/phoenix infonews channel/phoenix chinese news
星空卫视	star_ws	星空卫视/星空台/星空/星空卫星电视/星空卫星频道/星空卫星/xing kong/星空卫星台
中国金融	zhongguoji	cfc中国金融/新华社cfc中国金融频道/新华社cfc中国金融/新华财经/新华经视/中国金融台/中国金融/新华社cfc财经频道/新华社cfc财经/cfc财经频道/cfc财经
湖南体彩	hn_tc	湖南体彩
长沙新闻	cs_xw	长沙新闻频道/长沙新闻/长沙电视台新闻频道/长沙电视台新闻/长沙台新闻频道/长沙台新闻/湖南长沙新闻频道/湖南长沙新闻/湖南长沙电视台新闻频道/湖南长沙电视台新闻/长沙新闻频道台
政法频道	zhengfa	政法频道/政法
女性频道	nvxing	女性频道/女性
经贸频道	jingmao	经贸频道/经贸
长沙互动	cs_hd	长沙互动
环球购物	huangqiu_g	环球购物
记录频道	jilu	记录频道/记录
长沙新闻广播	cs_xwgb	长沙新闻广播
长沙经济之声	cs_jizs	长沙经济之声
长沙交通音乐	cs_jtyy	长沙交通音乐
长沙城市之音	cs_cszy	长沙城市之音
中国之声	zhongguo_z	中国之声
经济之声	jingji_zs	经济之声
音乐之声	yinyue_zs	音乐之声
华夏之声	huaxia_zs	华夏之声
神州之声	shenzhou_z	神州之声
中华之声	zhonghua_z	中华之声
湖南经视	hn_js	湖南经视/湖南经济电视台综合频道/湖南经济电视台综合/湖南etv综合频道/湖南etv综合/湖南经济台综合频道/湖南经济台综合/湖南经济综合频道/湖南经济综合/湖南经视综合频道/湖南经视综合/etv综合/湖南经济综合台/湖南经视综合台
湖南娱乐	hn_yl	湖南娱乐频道/湖南娱乐/湖南电视台娱乐频道/湖南电视台娱乐/湖南娱乐台
湖南公共	hn_gg	湖南公共频道/湖南公共/湖南电视台公共频道/湖南电视台公共/湖南台公共/湖南公共台
快乐购物	kuaile_gw	快乐购/湖南电视台快乐购物频道/湖南电视台快乐购物/湖南购物/湖南卫视快乐购/快乐go/湖南快乐购物/湖南台快乐购/快乐购物
金鹰纪实	aniworld_j	金鹰纪实频道/金鹰纪实/湖南经济电视台金鹰纪实频道/湖南经济电视台金鹰纪实/湖南etv金鹰纪实/湖南经济电视台生活频道/湖南经济电视台生活/湖南经济金鹰纪实频道/湖南经济金鹰纪实/湖南经济台金鹰纪实频道/湖南经济台金鹰纪实/金鹰纪实频道  湖南经视/湖南金鹰纪实频道/湖南金鹰纪实
金鹰卡通	aniworld_k	湖南金鹰卡通频道/湖南金鹰卡通/湖南电视台金鹰卡通频道/湖南电视台金鹰卡通/湖南台金鹰卡通频道/湖南台金鹰卡通/金鹰卡通/湖南卫视金鹰卡通频道/湖南卫视金鹰卡通/湖南金鹰卡通卫视/金鹰卡通频道
潇湘电影	xiaoxiang_	湖南潇湘电影频道/湖南潇湘电影/湖南电视台潇湘电影频道/湖南电视台潇湘电影/湖南台潇湘电影频道/湖南台潇湘电影/潇湘电影/湖南潇湘电影台/潇湘电影频道/潇湘电影台/湖南电影/湖南电影频道
家庭消费	jiatingxia	家庭消费
卡酷少儿	kaku_se	卡酷少儿
湖南经视高清	hn_js_hd	湖南经视高清
DOX映画	dox_yh	dox映画/dox映画高清/dox影画/映画频道/映画/星元映画/dox电影/dox影院/经典电影频道/经典电影
DOX剧场	dox_jc	dox剧场/dox剧场高清/dox‧剧场/热播美剧频道/热播美剧
DOX新知	dox_xz	dox新知/dox‧新知/新知频道/新知/dox纪实/自然传奇频道/自然传奇
DOX新艺	dox_xy	dox新艺/dox‧新艺/新艺频道/新艺/环球新艺/dox时尚
DOX怡家	dox_yj	dox怡家/宝岛怡家/星元怡家
DOX院线	dox_yx	dox院线/dox院线频道/院线电影/星元院线/高清佳片有约
篮球	lanqiu	篮球频道/篮球
卫生健康	weishengji	卫生健康/sitv卫生健康/卫生健康频道/上海卫生健康频道/上海卫生健康
界面广告	jiemiangua	界面广告
天元围棋	tianyuanwe	天元围棋/中数传媒天元围棋/天元围棋频道/贵州电视台天元围棋频道/贵州电视台天元围棋/贵州天元围棋频道/贵州天元围棋
发现之旅	faxianzhil	发现之旅/cctv发现之旅频道/cctv发现之旅/央视数字电视发现之旅频道/央视数字电视发现之旅
环球奇观	huanqiuqig	环球奇观/环球奇观频道/cctv环球奇观频道/cctv环球奇观
书画	shuhua	书画频道/书画/中央电视台书画频道/中央电视台书画/中央数字电视书画频道/中央数字电视书画/中国书画频道/中国书画/央书画频道/央书画/cctv书画频道/cctv书画
北京纪实标清	bj_js_sd	北京纪实标清
国安导视	guoandaosh	国安导视
央广健康	yangguangj	央广健康/家庭健康频道/家庭健康/母婴健康/cnr care
宝贝家	baobeijia	宝贝家/宝贝家频道/宝贝家付费频道/宝贝家付费/宝贝家亲子频道/宝贝家亲子/育婴宝典
高尔夫	gaoerfu	高尔夫
欧洲足球	europe_zq	欧洲足球/欧洲足球台/欧洲足球频道/广东电视台欧洲足球频道/广东电视台欧洲足球
国防军事	guofang_js	国防军事/中数传媒国防军事/cctv国防军事频道/cctv国防军事/国防军事频道/国防军事台
摄影频道	sheying_pd	摄影频道/摄影/中数传媒摄影频道/中数传媒摄影/cctv摄影频道/cctv摄影/贵州电视台摄影频道/贵州电视台摄影/贵州摄影频道/贵州摄影/摄影指南/贵州摄影台
优优宝贝	youyoubaob	优优宝贝/优优宝贝频道/北广传媒优优宝贝/亲亲宝贝频道/亲亲宝贝
英语辅导	yingyufuda	英语辅导
收藏天下	shoucangti	收藏天下/收藏天下频道/山东电视台收藏天下频道/山东电视台收藏天下/山东台收藏天下频道/山东台收藏天下/数字电视收藏天下频道/数字电视收藏天下/天下收藏
七彩戏剧	qicai_xj	七彩戏剧/sitv七彩戏剧/sitv七彩戏剧频道/七彩戏剧频道/上海七彩戏剧频道/上海七彩戏剧/七彩剧场
金色频道	jinse	金色频道/金色/sitv金色频道/sitv金色/上海金色频道/上海金色
法治天下	fazhitianx	法治天地/sitv法治天地/sitv法治天地频道/法治天下/法治天下频道/上海法治天地频道/上海法治天地/法制天地/sitv法制天地/sitv法治天下
央视台球	cctv_tq	央视台球
家庭理财	family_lc	家庭理财/家庭理财频道/辽宁家庭理财
老年福	laonianfu	老年福/cctv老年福/中数传媒老年福/老年福频道/山西老年福频道/山西老年福/老年频道/老年
百姓健康	baixingjia	百姓健康/数字电视百姓健康频道/数字电视百姓健康/百姓健康频道/付费电视百姓健康
四海钓鱼	sihaidiaoy	四海钓鱼/四海钓鱼频道/央视数字电视四海钓鱼频道/央视数字电视四海钓鱼
快乐宠物	kuailechon	快乐宠物/广东快乐宠物频道/广东快乐宠物/广东电视台快乐宠物频道/广东电视台快乐宠物/宠物汇频道/宠物汇
现代房产	xiandaifan	现代房产
长株潭二	czt_2	长株潭二套/长株潭二/长株潭频道二/长株潭二台
长株潭三	czt_3	长株潭三套/长株潭三/长株潭3/长株潭频道三/长株潭三台
现代女性	xiandainvx	现代女性/中数传媒现代女性/现代女性频道/现代女性台
长沙公共	cs_gg	长沙公共频道/长沙公共/长沙电视台公共频道/长沙电视台公共/长沙台公共频道/长沙台公共/长沙公共台
科学生活	kexuesheng	科学生活
地方戏曲	difang_xq	地方戏曲/影视欣赏/大众影院/艺华影院
财富剧场	caifu	财富剧场
炫动卡通	xuandong_k	炫动卡通/上海炫动卡通/上海炫动卫视/炫动卡通卫视
证券资讯	zhengjuan_	证券资讯
郴州台	binzhou	郴州新闻综合/郴州电视台新闻综合频道/郴州电视台新闻综合/郴州台/郴州/郴州新闻综合台
嘉丽购物	jiali_gw	嘉丽购物
长沙新闻高清	cs_xw_hd	长沙新闻高清
长沙政法高清	cs_zf_hd	长沙政法高清
魅力音乐高清	wl_yy_hd	魅力音乐高清
劲爆体育高清	jb_ty_hd	劲爆体育高清/劲爆体育hd
全纪实高清	qjs_hd	全纪实高清
欢笑剧场高清	hljc_hd	欢笑剧场高清/欢笑剧场hd
优购物	you_gw	优购物
家有购物	youjia_gw	家有购物/吉视家有购物/贵州7台/贵州7
央广购物	yangguang_	央广购物
好享购物	haoxiang_g	好享购物频道/好享购物/江苏电视台好享购物频道/江苏电视台好享购物/好享购
购物版块	gouwu	购物版块
家家购物	jiajia_gw	家家购物/家家购/家家购物1
高清探索	ts_hd	高清探索频道/高清探索/天天高清探索/天华高清探索/天华探索/nvod探索/华尚高清探索/dv高清综艺/天天映像频道/天天映像/探索高清
高清体育	ty_hd	体育高清/高清体育
高清综艺	zy_hd	综艺高清/高清综艺
高清影视	ys_hd	高清影视频道/高清影视/天天高清影院/高清影院/天华高清影院/天华影院/天天高清影视/nvod影院/华尚高清影院/天华高清影视/dv高清影院/高清电影nvod/高清电视剧nvod/天天影院频道/天天影院/影视高清
卫视版块	weishi	卫视版块
上海纪实	shanghaiji	上海纪实
风尚购物	fengshang_	风尚购物频道/风尚购物/江西风尚购物频道/江西风尚购物
长沙县新闻综合	csx_xwzh	长沙县新闻综合
娄底综合	loudi_zh	娄底综合频道/娄底综合/娄底电视台综合频道/娄底电视台综合/娄底综合台
游戏风云高清	gamefy_hd	游戏风云高清
极速汽车高清	js_car_hd	极速汽车高清
搏击高清	fight_hd	搏击高清
陶瓷高清	ceramics_h	陶瓷高清
第一剧场	first_jc	第一剧场/中数传媒第一剧场/cctv第一剧场/央视第一剧场/第一剧场频道/中央第一剧场/第一剧场台
新科动漫	xinke_dm	新科动漫/cctv新科动漫/中央电视台新科动漫/央视新科动漫频道/央视新科动漫/新科频道/新科
风云音乐	fengyun_yy	风云音乐/中数传媒风云音乐/中央电视台收费频道风云音乐/cctv风云音乐/中央电视台风云音乐/风云音乐频道/风云音乐台
风云足球	fengyun_zq	风云足球/中数传媒风云足球/cctv风云足球/足球风云/cctv风云足球频道/足球风云频道/cctv风云足球台/足球风云台
国学频道	guoxue	国学/国学频道/说文解字电视频道/说文解字电视/说文解字频道/说文解字/说文解字数字付费电视频道/说文解字数字付费电视/sitv说文解字频道/sitv说文解字
汽摩	qimo	汽摩/cctv汽摩/中数传媒汽摩/汽摩频道/重庆汽摩频道/重庆汽摩/中国汽摩/cqtv汽摩
江苏卫视	js_ws	江苏卫视/江苏卫视台/江苏卫星/江苏卫星电视/江苏卫星频道/江苏电视卫视频道/江苏电视卫视/jstv/荔枝台/荔枝/jiangsusatellitechannel/江苏电视台/江苏电视/江苏台/大蒜台/江苏tv
中央教育	cctv_jy	中央教育
天津卫视	tj_ws	天津卫视/天津卫视频道/天津卫星电视/天津卫星频道/天津卫星/天津电视卫星频道/天津电视卫星/天津电视台/天津电视/天津台/天津/鱼钩台/天津tv
湖南卫视	hn_ws	湖南卫视频道/湖南卫视台/湖南卫星电视/湖南卫星频道/湖南卫星/芒果台/芒果/湖南电视台/湖南电视/湖南台/马桶台/湖南卫视/湖南tv
浙江卫视	zj_ws	浙江卫视/浙江卫视频道/浙江卫星电视/浙江卫星频道/浙江卫星/蓝莓台/蓝莓/浙江电视台/浙江电视/浙江台/浙江/浙江tv/中国蓝/中国蓝tv
重庆卫视	cq_ws	重庆卫视/重庆电视卫星频道/重庆电视卫星/重庆台卫星频道/重庆台卫星/重庆卫星电视/重庆卫星电视台/重庆卫星频道/重庆卫星/cqtv/重庆电视台/重庆电视/重庆台/地球台/重庆tv
山东卫视	sd_ws	山东卫视/山东卫星频道/山东卫星/sdtv/丝带台/丝带/齐鲁电视台/齐鲁电视/山东电视卫星频道/山东电视卫星/山东电视台/山东电视/山东台/山东/围巾台/山东tv
贵州卫视	gz_ws	贵州卫视/贵州卫视频道/贵州卫星电视/贵州卫星频道/贵州卫星/樱桃台/樱桃/贵州电视台/贵州电视/贵州台/贵州tv
四川卫视	sc_ws	四川卫视/sctv1/四川电视卫星频道/四川电视卫星/四川台卫星频道/四川台卫星/四川卫星电视/四川卫星电视台/四川卫星频道/四川卫星/四川卫视台/四川电视台/四川电视/四川1/四川台/四川/旋风台/四川tv
辽宁卫视	ln_ws	辽宁卫视/辽宁电视卫星频道/辽宁电视卫星/辽宁卫星电视/辽宁卫星电视台/辽宁卫星频道/辽宁卫星/辽视卫视/辽视卫星频道/辽视卫星/辽宁电视台/辽宁电视/辽宁卫星台/辽宁台/辽宁/星星台/辽宁tv
广西卫视	gx_ws	广西卫视/广西卫视频道/广西卫星电视/广西卫星频道/广西卫星/广西卫视台/广西电视台/广西电视/广西台/广西tv
四川卫视高清	sc_ws_hd	四川卫视高清/四川高清
河北卫视高清	hebei_ws_h	河北卫视高清/河北高清
河北卫视	hebei_ws	河北卫视/河北电视台新闻综合频道/河北电视台新闻综合/河北卫视频道/河北卫星电视/河北卫星频道/河北卫星/河北电视台/河北电视/河北台/河北tv
江西卫视	jx_ws	江西卫视/江西1套/江西1/江西卫视电视台/江西卫视电视/江西卫星/江西一套/江西一/jxtv1/辣椒台/辣椒/江西电视台/江西电视/江西1台/江西卫视台/江西台/江西/江西tv
湖北卫视	hb_ws	湖北卫视/湖北卫视频道/湖北卫星电视/湖北卫星频道/湖北卫星/水珠台/水珠/烟斗台/烟斗/湖北台/湖北电视台/柠檬台/湖北tv/湖北电视
陕西卫视	sx_ws	陕西卫视/陕西电视卫星频道/陕西电视卫星/陕西台卫星频道/陕西台卫星/陕西卫星电视/陕西卫星电视台/陕西卫星频道/陕西卫星/闪电台/闪电/陕西电视台/陕西电视/陕西台/陕西tv
甘肃卫视	gs_ws	甘肃卫视/甘肃卫视频道/甘肃卫星电视/甘肃卫星频道/甘肃卫星/甘肃卫视台/甘肃台/甘肃电视台/甘肃tv/甘肃电视
安徽卫视	ah_ws	安徽卫视/ahtv/安徽卫视频道/安徽卫星频道/安徽卫星/海豚台/海豚/安徽电视台/安徽电视/安徽台/安徽/安徽tv
青海卫视	qh_ws	青海卫视/青海卫视频道/青海卫星电视/青海卫星频道/青海卫星/青海新闻综合频道/青海新闻综合/青海电视台/青海电视/qhtv/青海台/青海/气球台/青海tv
黑龙江卫视	hlj_ws	黑龙江卫视/黑龙江电视卫星频道/黑龙江电视卫星/黑龙江台卫星频道/黑龙江台卫星/黑龙江卫星电视/黑龙江卫星电视台/黑龙江卫星频道/黑龙江卫星/黑龙江电视台/黑龙江电视/黑龙江台/黑龙江/黑龙江tv
广东卫视	gd_ws	广东卫视/广东卫视频道/广东卫星电视/广东卫星频道/广东卫星/gdtv1/体操台/体操/广东电视台/广东电视/广东台/广东tv
吉林卫视	jl_ws	吉林卫视/吉林电视卫星频道/吉林电视卫星/吉林卫星电视/吉林卫星电视台/吉林卫星频道/吉林卫星/吉视卫视/吉视卫星电视/吉视卫星频道/吉视卫星/吉林卫视电视台/吉林卫视电视/吉林电视台/吉林电视/吉林台/吉林/天鹅台/吉林tv
东方财经	df_cj	东方财经·浦东/sitv数字电视sitv东方财经/sitv东方财经频道/sitv东方财经/东方财经频道/东方财经/上海东方财经频道/上海东方财经
宁夏卫视	nx_ws	宁夏卫视/宁夏卫视频道/宁夏卫星电视/宁夏卫星频道/宁夏卫星/宁夏卫视台/宁夏电视台/宁夏电视/宁夏台/宁夏/宁夏tv
兵团卫视	bt_ws	兵团卫视/新疆兵团卫视/兵团电视台/兵团电视/新疆建设兵团/兵团综合频道/兵团综合/兵团台/兵团tv
西藏卫视	xz_ws	西藏卫视/西藏电视台汉语卫视/西藏电视台2/西藏台汉语综合频道/西藏台汉语综合/西藏二套/西藏二/西藏2套/西藏2/西藏二台/西藏2台/西藏汉语卫视/西藏电视台/西藏电视/西藏汉语综合/西藏台/西藏/飞碟台/西藏tv
新疆卫视	xj_ws	新疆卫视/xjtv－1/新疆卫视频道/新疆卫星电视/新疆卫星频道/新疆卫星/xjtv1/新疆汉语卫视/新疆汉语新闻综合/新疆电视台/新疆电视/新疆台/新疆/金鱼台/新疆tv
东方卫视高清	df_ws_hd	东方卫视高清/上海高清/上海东方高清/上海卫视高清
浙江卫视高清	zj_ws_hd	浙江卫视高清/浙江高清
江西卫视高清	jx_ws_hd	江西卫视高清
CCTV5+	cctv5+	cctv5+/cctv5加/cctv体育赛事频道/cctv体育赛事/cctv高清赛事频道/cctv高清赛事/cctv5plus/央体赛事/央视高清赛事/cctv5赛事频道/cctv5赛事/cctv5体育赛事/中央赛事频道/中央赛事/中央赛事台/中央五加/央视五加/cctv五+/中央电视台五+/中央电视台5加/中央电视五+/中央电视5加/中央tv五+/中央tv5加/cctv五加/中央电视台五加/中央电视台5+/中央电视五加/中央电视5+/中央tv五加/中央tv5+/cctv5赛事高清/cctv5赛事hd
合肥新闻频道	hefeitv1	合肥新闻频道/合肥新闻/合肥电视台新闻频道/合肥电视台新闻/合肥台1频道/合肥台1/合肥台新闻频道/合肥台新闻/合肥一套/合肥一/合肥综合频道/合肥综合/合肥1套/合肥1/合肥台新闻台/合肥一台/合肥综合台
重庆新闻频道	ccqtv3	重庆新闻频道/重庆新闻/重庆电视台新闻频道/重庆电视台新闻/重庆台新闻频道/重庆台新闻/重庆二套/重庆二/重庆2套/重庆2/cqtv2/cqtv新闻/重庆二台
重庆娱乐频道	ccqtv6	重庆娱乐频道/重庆娱乐/重庆电视台娱乐频道/重庆电视台娱乐/重庆台娱乐频道/重庆台娱乐/重庆五套/重庆五/重庆5套/重庆5/cqtv5/cqtv娱乐/重庆文体娱乐频道/重庆文体娱乐/cqtv文体·娱乐/重庆五台
厦门收视指南	xmtv6	厦门收视指南/厦门电视台收视指南频道/厦门电视台收视指南/btn收视指南
泉州影视频道	qztv3	泉州影视频道/泉州影视/泉州电视台影视频道/泉州电视台影视/泉州3套/泉州3/泉州电视台3/泉州电视台3套/泉州电视台三套/泉州电视台三/泉州三套/泉州三/qztv3/泉州影视剧频道/泉州影视剧/泉州三台
甘肃公共频道	gstv4	甘肃公共频道/甘肃公共/甘肃电视台公共频道/甘肃电视台公共/甘肃台公共频道/甘肃台公共/甘肃公共台/甘肃公共电视台/甘肃公共电视
甘肃都市频道	gstv5	甘肃都市频道/甘肃都市/甘肃电视台都市频道/甘肃电视台都市/甘肃台都市频道/甘肃台都市/甘肃都市电视台/甘肃都市电视/甘肃都市台
广州新闻频道	gztv2	广州新闻频道/广州新闻/广州电视台新闻频道/广州电视台新闻/广视新闻频道/广视新闻/广州新闻台/广州卫视新闻频道/广州卫视新闻/gztv2
TVS4影视频道	nanfang4	tvs4影视频道/tvs4影视
广西综艺频道	guanxi2	广西综艺频道/广西综艺/广西电视台综艺频道/广西电视台综艺/gxtv 文体频道/gxtv 文体/广西台文体频道/广西台文体/广西台文体台
广西乐思购频道	guanxi6	广西乐思购频道/广西乐思购/广西电视台乐思购频道/广西电视台乐思购/gxtv 体育频道/gxtv 体育/广西台体育频道/广西台体育/广西乐思购电视购物/广西体育频道/广西体育/广西体育台/广西乐思购电视台/广西乐思购电视
柳州新闻综合	gxlztv1	柳州新闻综合/柳州电视台新闻综合频道/柳州电视台新闻综合/柳州台新闻综合频道/柳州台新闻综合/柳州新闻频道/柳州新闻/柳州台新闻综合台/柳州新闻台
贵州公共频道	guizoutv2	贵州公共频道/贵州公共/贵州电视台二频道/贵州电视台二/贵视台公共频道/贵视台公共/贵州电视台百姓频道/贵州电视台百姓/贵州电视台公共频道/贵州电视台公共/贵州二台/贵州二/贵州2套/贵州2/贵州二套/贵州百姓频道/贵州百姓/贵州2频道
海南综合频道	hainantv1	海南综合频道/海南综合/海南电视台综合频道/海南电视台综合/海南新闻综合频道/海南新闻综合/海南第一频道/海南第一/海南一套/海南一/海南综合频道1/海南一套综合/海南电视台1/海南新闻综合台/海南一台
海口综合频道	haikoutv1	海口综合频道/海口综合/海口电视台新闻综合频道/海口电视台新闻综合/海口新闻频道/海口新闻/海口一套/海口一/海口电视台1/海口综合台/海口一台/海口新闻台/海口1套/海口1
衡水新闻频道	hsbtv1	衡水新闻频道/衡水新闻/衡水电视台新闻综合频道/衡水电视台新闻综合/衡水台一频道/衡水台一/衡水台一套/衡水一台/衡水一/衡水综合
黑龙江新闻	hljtv5	黑龙江新闻/黑龙江电视台新闻频道/黑龙江电视台新闻/黑龙江5频道/黑龙江5/黑龙江电视5套/黑龙江电视5/黑龙江台法制频道/黑龙江台法制/黑龙江法制台/黑龙江法制/hljtv5/黑龙江电视台法制频道/黑龙江电视台法制/黑龙江法制频道/龙视新闻频道/龙视新闻
哈尔滨生活频道	hrbtv3	哈尔滨生活频道/哈尔滨生活/哈尔滨电视台生活频道/哈尔滨电视台生活/哈尔滨台生活频道/哈尔滨台生活/hrbtv3
大庆影视频道	daqingtv3	大庆影视频道/大庆影视/大庆电视台影视频道/大庆电视台影视/大庆台影视频道/大庆台影视/大庆台影视台
河南欢腾购物频道	hntv7	河南欢腾购物频道/河南欢腾购物/河南电视台欢腾购物频道/河南电视台欢腾购物/河南电视台商务信息频道欢腾购物/河南商务频道欢腾购物/河南商务频道/河南商务/hntv7/hntv7商务信息/河南电视台7/河南电视台商务信息频道/河南电视台商务信息/河南商务信息频道/河南商务信息/河南七台/河南七
新乡新闻综合频道	hnxxtv1	新乡新闻综合频道/新乡新闻综合/新乡电视台新闻综合频道/新乡电视台新闻综合/河南新乡电视频道/河南新乡电视/新乡电视台/新乡电视/新乡一套/新乡一/新乡综合/新乡一台/新乡tv
新乡法制频道	hnxxtv2	新乡法制频道/新乡法制/新乡电视台法制频道/新乡电视台法制/新乡公共/新乡公共台
武汉新闻综合频道	whtv1	武汉新闻综合频道/武汉新闻综合/武汉电视台新闻综合频道/武汉电视台新闻综合/武汉电视台1套/武汉电视台1/武汉电视台新闻频道/武汉电视台新闻/武汉电视台一套/武汉电视台一/武汉卫视/武汉一套/武汉一/武汉新闻频道/武汉新闻/whtv1/武汉1/武汉新闻台/武汉一台
武汉经济频道	whtv4	武汉经济频道/武汉经济/武汉电视台经济频道/武汉电视台经济/武汉4台/武汉4/武汉4套/武汉电视台四套/武汉电视台四/武汉电视台影视/武汉四套/武汉四/武汉影视/whtv4/武汉四台/武汉台影视台/武汉台影视
荆州社区频道	jztv3	荆州社区频道/荆州社区/荆州电视台社区频道/荆州电视台社区/荆州精彩频道/荆州精彩/荆州电视精彩频道/荆州电视精彩/荆州电视台精彩频道/荆州电视台精彩
襄阳新闻综合频道	hbxftv1	襄阳新闻综合频道/襄阳新闻综合/襄阳电视台新闻综合频道/襄阳电视台新闻综合/襄樊1台/襄樊1/襄樊1套/襄樊一台/襄樊一/襄樊一套/襄樊电视台1/襄阳1台/襄阳1/襄阳1套/襄阳一台/襄阳一/襄阳电视台1/襄阳一套/襄阳电视台/襄阳电视/襄阳tv
长沙政法频道	changshawumon2	长沙政法频道/长沙政法/长沙电视台政法频道/长沙电视台政法/长沙台政法频道/长沙台政法/长沙法政/长沙政法台
江苏休闲体育频道	jstv6	江苏休闲体育频道/江苏休闲体育/江苏电视台休闲体育频道/江苏电视台休闲体育/江苏电视体育频道/江苏电视体育/江苏体育台/江苏体育/江苏体育休闲频道/江苏体育休闲/江苏休闲频道/江苏休闲/江苏体育频道
江苏优漫卡通频道	jstv7	江苏优漫卡通频道/江苏优漫卡通/江苏电视台优漫卡通频道/江苏电视台优漫卡通/江苏电视少儿频道/江苏电视少儿/江苏电视台少儿频道/江苏电视台少儿/江苏少儿频道/江苏少儿/优漫卡通卫视/江苏少儿优漫卡通频道/江苏少儿优漫卡通/优漫卫视/江苏动漫卡通/动漫卡通/江苏优漫
江苏国际频道	jstv10	江苏国际频道/江苏国际/江苏电视台国际频道/江苏电视台国际/江苏国际台
南京新闻综合频道	njtv1	南京新闻综合频道/南京新闻综合/南京电视台新闻综合频道/南京电视台新闻综合/江苏南京综合频道/江苏南京综合/南京电视台新闻频道/南京电视台新闻/南京台新闻频道/南京台新闻/南京综合频道/南京综合/南京新闻频道/南京新闻/南京台综合频道/南京台综合
南京影视频道	njtv2	南京影视频道/南京影视/南京电视台影视频道/南京电视台影视/江苏南京影视频道/江苏南京影视/南京台影视频道/南京台影视/南京影视台/南京二套/南京二/南京2套/南京2/南京2台/南京二台
苏州新闻综合频道	suzhoutv1	苏州新闻综合频道/苏州新闻综合/苏州电视台新闻综合频道/苏州电视台新闻综合/苏州台新闻综合频道/苏州台新闻综合/苏州一套/苏州一/苏州1套/苏州1/苏州新闻频道/苏州新闻
苏州电影娱乐频道	suzhoutv4	苏州电影娱乐频道/苏州电影娱乐/苏州电视台电影娱乐频道/苏州电视台电影娱乐/苏州台电影娱乐频道/苏州台电影娱乐/苏州四套/苏州四/苏州4套/苏州4/苏州娱乐频道/苏州娱乐/苏州电影频道/苏州电影/苏州电影娱乐信息/苏州四台
常熟城市财经频道	changshu2	常熟城市财经频道/常熟城市财经/常熟电视台城市财经频道/常熟电视台城市财经/常熟电视台城市生活频道/常熟电视台城市生活/常熟城市生活频道/常熟城市生活
常熟民生经济频道	changshu4	常熟民生经济频道/常熟民生经济/常熟电视台民生经济频道/常熟电视台民生经济
无锡教育频道	wuxi8	无锡教育频道/无锡教育/无锡电视台教育频道/无锡电视台教育/无锡台无锡教育/无锡教育台
休闲影视	jxxxys	休闲影视/休闲影视频道
大连公共频道	dalian3	大连公共频道/大连公共/大连电视台公共频道/大连电视台公共/dltv3/dltv法制频道/dltv法制/大连电视台3/大连法制台/大连法制/大连3套/大连3/大连3台/大连三台/大连三/大连三套/大连电视台法制频道/大连电视台法制/大连法制频道
大连影视频道	dalian5	大连影视频道/大连影视/大连电视台影视频道/大连电视台影视/dltv5/dltv影视频道/dltv影视/大连电视台5/大连影视台/大连5套/大连5/大连五套/大连五/大连五台/大连5台
大连财经频道	dalian7	大连财经频道/大连财经/大连电视台财经频道/大连电视台财经/大连7
丹东公共频道	ddtv2	丹东公共频道/丹东公共/丹东电视台公共频道/丹东电视台公共/ddtv生活文艺频道/ddtv生活文艺/丹东生活文艺台/丹东生活文艺/丹东2套/丹东2/丹东2台/丹东二台/丹东二/丹东二套/丹东电视台二套/丹东电视台二/丹东电视台生活文艺频道/丹东电视台生活文艺/丹东电视生活文艺频道/丹东电视生活文艺
丹东影视频道	ddtv3	丹东影视频道/丹东影视/丹东电视台影视频道/丹东电视台影视/ddtv影视频道/ddtv影视/丹东影视台/丹东3套/丹东3/丹东3台/丹东三台/丹东三/丹东三套/丹东电视台三套/丹东电视台三
山东农科频道	sdtv4	山东农科频道/山东农科/山东电视台农科频道/山东电视台农科/sdtv农科频道/sdtv农科/山东台农科频道/山东台农科/农科台/农科/山东农科台
山东有线海外频道	sdcatv4	山东有线海外频道/山东有线海外/山东有线电视台海外频道/山东有线电视台海外/sdcatv海外频道/sdcatv海外/山东有线台海外频道/山东有线台海外/sdcatv4/山东有线电视第四频道/山东有线电视第四/山东电视台国际频道/山东电视台国际/泰山电视台/泰山电视/山东国际频道/山东国际
锐TV	ruitv	锐tv/齐鲁锐tv
山东教育台	sdetv1	山东教育台/山东教育/山东教育电视台/山东教育电视/sdetv/山东教育频道/山东台教育/cetvsd
淄博科教频道	zbrt5	淄博科教频道/淄博科教/淄博电视台科教频道/淄博电视台科教/淄博科教台
潍坊新闻频道	sdwf1	潍坊新闻频道/潍坊新闻/潍坊电视台新闻综合频道/潍坊电视台新闻综合/sdwf1新闻综合频道/sdwf1新闻综合/潍坊新闻综合频道/潍坊新闻综合/潍坊综合频道/潍坊综合
哈哈少儿频道	shhai11	哈哈少儿频道/哈哈少儿/上海电视台哈哈少儿频道/上海电视台哈哈少儿/上海哈哈少儿电视台/上海哈哈少儿电视/上海台东方哈哈少儿频道/上海台东方哈哈少儿/上海台哈哈少儿频道/上海台哈哈少儿/上视电视台哈哈少儿频道/上视电视台哈哈少儿/上视哈哈少儿频道/上视哈哈少儿
中国交通频道	zgjtpd	中国交通频道/中国交通
游戏风云	sitv2	游戏风云/新视觉hd游戏/新视觉游戏
全纪实	sitv11	全纪实/新视觉高清纪实/上海新视觉纪实高清/新视觉纪实/新视觉_纪实/新视觉hd纪实/全纪实hd/新视觉纪实高清/纪实高清
陕西四套	shxitv5	陕西四套/陕西四/陕西电视台影视娱乐频道/陕西电视台影视娱乐/陕视影视娱乐频道/陕视影视娱乐/陕西电视/陕西电视台4套/陕西电视台4/陕西台影视娱乐频道/陕西台影视娱乐/陕西影视娱乐频道/陕西影视娱乐/陕西影视/陕西4套/陕西4/陕西四台/陕西4台/sxtvs4
陕西六套	shxitv7	陕西六套/陕西六/陕西电视台乐家电视购物频道/陕西电视台乐家电视购物/陕西电视台6套/陕西电视台6/陕西乐家电视购物频道/陕西乐家电视购物/sxtvs6/陕西电视购物频道/陕西电视购物/陕西6套/陕西6/陕西6台/陕西六台
四川妇女儿童频道	sctv7	四川妇女儿童频道/四川妇女儿童/四川电视台妇女儿童频道/四川电视台妇女儿童/sctv7/sctv7妇儿频道/sctv7妇儿/四川电视台7套/四川电视台7/四川台妇女儿童频道/四川台妇女儿童/四川七套/四川七/四川7套/四川7/四川7台/四川七台/四川妇儿/四川妇女少儿
成都新闻综合频道	chengdu1	成都新闻综合频道/成都新闻综合/成都电视台新闻综合频道/成都电视台新闻综合/cdtv1/成都新闻频道/成都新闻/成都综合频道/成都综合/cdtv1新闻综合
天津少儿频道	tjtv8	天津少儿频道/天津少儿/天津电视台少儿频道/天津电视台少儿/天津台少儿频道/天津台少儿/tjtv7少儿/天津电视少儿频道/天津电视少儿/tjtv少儿/天津7套/天津7/天津7台/天津七套/天津七
浙江教育科技	zjtv4	浙江教育科技/浙江电视台教育科技频道/浙江电视台教育科技/浙江卫视4套/浙江卫视4/cztv4/ztv教育科技/ztv4/浙江卫视四台/浙江卫视四
浙江少儿频道	zjtv8	浙江少儿频道/浙江少儿/浙江电视台少儿频道/浙江电视台少儿/cztv8/ztv8
杭州西湖明珠	htv2	杭州西湖明珠/杭州电视台西湖明珠频道/杭州电视台西湖明珠/杭州台西湖明珠频道/杭州台西湖明珠/明珠电视台/明珠电视/西湖明珠台/西湖明珠/西湖明珠频道/杭州西湖明珠电视台/杭州西湖明珠电视/杭州西湖明珠台/htv2/杭州二套/杭州二/杭州2套/杭州2/htv2西湖明珠/杭州二台
杭州文化频道	htv6	杭州文化频道/杭州文化/杭州电视台文化频道/杭州电视台文化/杭州台导视频道/杭州台导视/杭州六套/杭州六/杭州6套/杭州6/htv6/htv6杭州导视/杭州导视/杭州导视纪录频道/杭州导视纪录/杭州台导视台/杭州六台
温州新闻综合	wztv1	温州新闻综合/温州电视台新闻综合频道/温州电视台新闻综合/温州台新闻综合频道/温州台新闻综合/温州1台/温州1/温州新闻综合台/温州一台/温州一
湖州文化娱乐	huzhoutv2	湖州文化娱乐/湖州电视台文化娱乐频道/湖州电视台文化娱乐/湖州台文化娱乐频道/湖州台文化娱乐/湖州文化频道/湖州文化/湖州娱乐频道/湖州娱乐
青海影视综艺频道	qhtv4	青海影视综艺频道/青海影视综艺/青海电视台影视综艺频道/青海电视台影视综艺/青海影视台/青海影视/青海综艺频道/青海综艺/青海都市频道/青海都市
临汾四套	linfentv4	临汾四套/临汾四/临汾电视台四套/临汾电视台四/临汾4套/临汾4/临汾台四套/临汾台四/临汾4台/临汾四台/四台/四
枣庄教育频道	zaozhuang1	枣庄教育频道/枣庄教育/枣庄电视台教育频道/枣庄电视台教育/枣庄台教育频道/枣庄台教育/枣庄教育电视台/枣庄教育电视/枣庄教育台
汕头经济生活	srttv2	汕头经济生活/汕头电视台经济生活频道/汕头电视台经济生活/汕头2台/汕头2/汕头2套/汕头二套/汕头二/汕头经济生活频道/汕头二台
三门峡综合频道	sanmengxia1	三门峡综合频道/三门峡综合/三门峡电视台新闻综合频道/三门峡电视台新闻综合/三门峡1台/三门峡1/三门峡1套/三门峡一台/三门峡一/三门峡一套/三门峡新闻综合频道/三门峡新闻综合/三门峡新闻频道/三门峡新闻
动感音乐	bamc5	动感音乐/动感音乐频道
置业频道	bamc11	置业频道/置业/数字电视置业频道/数字电视置业/北广传媒数字电视置业频道/北广传媒数字电视置业/北京置业频道/北京置业
教育就业频道	channeledu	教育就业/教育就业频道
房产频道	fangchan	房产频道/房产/房产台/广东电视台房产频道/广东电视台房产/广东房产/现代房产
福建教育频道	fetv	福建教育频道/福建教育/fetv/福建教育台
时尚购物	ssgo	时尚购物/重庆时尚购物
BBC WORLD NEWS	bbc_world_news_asia	bbc world news/bbc world news新闻频道/bbc world news新闻/bbc asia/bbc schedule/bbc国际新闻电视频道/bbc国际新闻电视/bbc新闻台国际频道/bbc新闻台国际/bbc world news 频道/bbc world/bbc世界新闻台/bbc世界新闻/世界新聞台/世界新聞/bbc 英國廣播公司新聞台/bbc 英國廣播公司新聞/bbc 英國廣播公司高清新聞台/bbc 英國廣播公司高清新聞/bbc world news 世界新聞台/bbc world news 世界新聞/bbc新聞台/bbc新聞/bbc
IPTV经典电影	iptvjddy	iptv经典电影/iptv经典
IPTV热播剧场	iptvrbjc	iptv热播剧场
高清动画频道	gqdhnvod	高清动画频道/高清动画/nvod高清动画/nvod 高清动画/动画频道高清
星元国剧	xygj	星元国剧
星元韩剧	xyhj	星元韩剧
FOX SPORTS	espn_cn	fox sports/fox体育台/fox体育/espn/espn中文/fox sport/fox sports hd yeni
天天购物	ttgw	天天购物
IPTV女人	nvren	iptv女人
IPTV动作影院	iptvdzyy	iptv动作影院
内蒙古足球频道	nmgzq	内蒙古足球频道/内蒙古足球
赤峰综合频道	chifengzh	赤峰综合频道/赤峰综合/赤峰电视台综合频道/赤峰电视台综合/赤峰综合台
扬州邗江频道	yzhanj	扬州邗江频道/扬州邗江/扬州邗江台
鞍山导视频道	ahshantv5	鞍山导视频道/鞍山导视/鞍山电视台导视频道/鞍山电视台导视
晋中综合频道	xsjztv1	晋中综合频道/晋中综合/晋中电视台新闻综合频道/晋中电视台新闻综合/晋中一套/晋中一/晋中1/晋中一台
乌鲁木齐维语频道	utv2	乌鲁木齐维语频道/乌鲁木齐维语/乌鲁木齐电视台维语频道/乌鲁木齐电视台维语/乌鲁木齐台2/utv2/乌鲁木齐电视台维语新闻综合频道/乌鲁木齐电视台维语新闻综合/乌鲁木齐台二台/乌鲁木齐台二
乌鲁木齐文体娱乐	utv5	乌鲁木齐文体娱乐/乌鲁木齐电视台文体娱乐频道/乌鲁木齐电视台文体娱乐/乌鲁木齐台5/utv5/乌鲁木齐电视台旅游娱乐频道/乌鲁木齐电视台旅游娱乐/乌鲁木齐旅游频道/乌鲁木齐旅游/乌鲁木齐台五台/乌鲁木齐台五
聊城综合频道	lctv1	聊城综合频道/聊城综合/聊城电视台新闻综合频道/聊城电视台新闻综合/lctv1/聊城新闻频道/聊城新闻/聊城综合台
吉林市生活频道	jlctv4	吉林市生活频道/吉林市生活/吉林市电视台经济生活频道/吉林市电视台经济生活/吉林市生活台
本溪三套	bxtv3	本溪三套/本溪三/本溪电视台生活频道/本溪电视台生活/本溪3/本溪三台
锦州三套	jinzhoutv3	锦州三套/锦州三/锦州电视台公共影视频道/锦州电视台公共影视/锦州电视台3/锦州三台
遵义综合频道	gzzytv1	遵义综合频道/遵义综合/遵义电视台新闻综合频道/遵义电视台新闻综合/遵义新闻综合台/遵义新闻综合
FASHION TV	fashion_tv	fashion tv/法国时尚台/法国时尚/fashiontv/法国时装台/法国时装/ftv.com/時尚頻道
蚌埠生活频道	ahbbtv2	蚌埠生活频道/蚌埠生活/蚌埠电视台生活频道/蚌埠电视台生活
金昌公共频道	gsjctv2	金昌公共频道/金昌公共/金昌电视台公共频道/金昌电视台公共/金昌公共台
玉溪新闻频道	ynyxtv1	玉溪新闻频道/玉溪新闻/玉溪电视台新闻综合频道/玉溪电视台新闻综合/玉溪一台/玉溪一
宜春一套	jxyctv1	宜春一套/宜春一/宜春电视台一套/宜春电视台一/宜春一台
宜春二套	jxyctv2	宜春二套/宜春二/宜春电视台二套/宜春电视台二/宜春二台
绵阳影视科技频道	scmytv3	绵阳影视科技频道/绵阳影视科技/绵阳电视台影视科技频道/绵阳电视台影视科技/绵阳科技/绵阳3/绵阳三台/绵阳三
绵阳教育资讯频道	scmytv4	绵阳教育资讯频道/绵阳教育资讯/绵阳电视台教育资讯频道/绵阳电视台教育资讯/绵阳4/绵阳四台/绵阳四
德州新闻频道	dztv1	德州新闻频道/德州新闻/德州电视台新闻频道/德州电视台新闻/德州电视台综合频道/德州电视台综合/德州综合/德州新闻台
株洲综合频道	hnzztv1	株洲综合频道/株洲综合/株洲电视台新闻综合频道/株洲电视台新闻综合/株洲新闻综合频道/株洲新闻综合/株洲新闻综合台
黄石公共垄上频道	hbhstv2	黄石公共垄上频道/黄石公共垄上/黄石电视台公共垄上频道/黄石电视台公共垄上/黄石公共频道/黄石公共/黄石公共台
黄石都市频道	hbhstv3	黄石都市频道/黄石都市/黄石电视台都市社区频道/黄石电视台都市社区/黄石都市社区台/黄石都市社区
周口新闻频道	hnzktv1	周口新闻频道/周口新闻/周口电视台新闻综合频道/周口电视台新闻综合/周口综合频道/周口综合/周口一套/周口一/周口新闻综合频道/周口新闻综合/周口新闻综合台
电视剧场	dianshijc	电视剧场
益阳新闻综合频道	yyrtvxw	益阳新闻综合频道/益阳新闻综合/益阳电视台新闻综合频道/益阳电视台新闻综合/益阳新闻频道/益阳新闻/益阳新闻综合台
鄂尔多斯经济服务	eedstv3	鄂尔多斯经济服务/鄂尔多斯电视台经济服务频道/鄂尔多斯电视台经济服务/鄂尔多斯2/鄂尔多斯二台/鄂尔多斯二
平顶山城市频道	pdstv2	平顶山城市频道/平顶山城市/平顶山电视台城市频道/平顶山电视台城市/平顶山城市台
娄底公共频道	ldtv2	娄底公共频道/娄底公共/娄底电视台公共频道/娄底电视台公共/娄底公共台
东森电影台	ettv1	东森电影台/东森电影/东森电影频道/台湾东森电影台/台湾东森电影
眉山影视剧频道	mstv2	眉山影视剧频道/眉山影视剧/眉山电视台影视剧频道/眉山电视台影视剧/眉山二台/眉山二/眉山影视频道/眉山影视/眉山影视台
睛彩阳泉	jcyq	睛彩阳泉
阳江综合频道	yangjtv	阳江综合频道/阳江综合/阳江电视台综合频道/阳江电视台综合
经典影院	jingdianyy	经典影院
自然探索	zirants	自然探索
资阳新闻综合频道	suiytv	资阳新闻综合频道/资阳新闻综合/资阳电视台新闻综合频道/资阳电视台新闻综合
葛洲坝台	gzbtv	葛洲坝台/葛洲坝/葛洲坝电视台/葛洲坝电视/葛洲坝tv
淮北新闻综合频道	ahhbtv1	淮北新闻综合频道/淮北新闻综合/淮北电视台新闻频道/淮北电视台新闻/淮北新闻频道/淮北新闻
溧水商务	lishuisw	溧水商务/溧水电视台商务频道/溧水电视台商务
合肥生活频道	hefeitv2	合肥生活频道/合肥生活/合肥电视台生活频道/合肥电视台生活/合肥台2频道/合肥台2/合肥台生活频道/合肥台生活/合肥二套/合肥二/合肥生活台/合肥二台
重庆少儿频道	ccqtv10	重庆少儿频道/重庆少儿/重庆电视台少儿频道/重庆电视台少儿/重庆青少台/重庆青少/重庆台青少频道/重庆台青少/cqtv青少/重庆电视台九套青少频道/重庆电视台九套青少/重庆电视台九套/重庆电视台九/cqtv9/重庆青少频道/cqtv少儿/重庆九台/重庆九
重庆国际频道	ccqtv11	重庆国际频道/重庆国际/重庆电视台国际频道/重庆电视台国际/重庆台国际频道/重庆台国际/cqtv国际/重庆卫视国际频道/重庆卫视国际
福建综合频道	fjtv1	福建综合频道/福建综合/福建电视台综合频道/福建电视台综合/福建电视综合频道/福建电视综合/福建综合电视台/福建综合电视/福建综合台/fjtv1/福建1综合
福建导视	fjds	福建导视
厦门影视频道	xmtv4	厦门影视频道/厦门影视/厦门电视台影视频道/厦门电视台影视/厦门电视影视频道/厦门电视影视/厦门四套/厦门四/厦门四套影视频道/厦门四套影视/厦门4套/厦门4/xmtv4/厦门四台
莆田经济生活频道	pttv2	莆田经济生活频道/莆田经济生活/莆田电视台经济生活频道/莆田电视台经济生活/莆田2套/莆田2/莆田二台/莆田二
龙岩新闻综合频道	fjly1	龙岩新闻综合频道/龙岩新闻综合/龙岩电视台新闻综合频道/龙岩电视台新闻综合/福建龙岩电视台/福建龙岩电视/龙岩电视台综合频道/龙岩电视台综合
新罗TV	jinjiangtv3	新罗tv
兰州公共频道	lanzhoutv4	兰州公共频道/兰州公共/兰州电视台公共频道/兰州电视台公共/兰州公共台/兰州台公共频道/兰州台公共/兰州公共电视台/兰州公共电视
珠江频道	gdtv2	珠江频道/珠江/广东电视台珠江频道/广东电视台珠江/gdtv珠江频道/gdtv珠江/广东台珠江频道/广东台珠江/广东珠江台/广东珠江/珠江台/广东珠江频道
广州生活频道	gztv5	广州生活频道/广州生活/广州电视台生活频道/广州电视台生活/广视英语频道/广视英语/广州英语频道/广州英语/广州英语台/广州卫视英语频道/广州卫视英语/广州电视台英语频道/广州电视台英语/广州台英语频道/广州台英语/广州生活台
中山教育频道	gdzs3	中山教育频道/中山教育/中山电视台教育频道/中山电视台教育/广东中山电视台教育频道/广东中山电视台教育/gdzs3
南方卫视	nanfang2	南方卫视/广东南方卫视/南方2台/南方2/南方tvs2南方卫视/南方电视台tvs2/南方卫视tvs2/南方卫视频道/南方卫星频道/南方卫星/南方2套/南方二套/南方二/南方二台/广东南方卫视上星版
TVS1经济频道	nanfang1	tvs1经济频道/tvs1经济
柳州生活科教	gxlztv2	柳州生活科教/柳州电视台生活科教频道/柳州电视台生活科教/柳州台生活科教频道/柳州台生活科教/柳州科教频道/柳州科教/柳州生活频道/柳州生活/柳州台生活科教台/柳州科教台/柳州生活台
柳州影视公共	gxlztv3	柳州影视公共/柳州电视台影视公共频道/柳州电视台影视公共/柳州台影视公共频道/柳州台影视公共/柳州公共频道/柳州公共/柳州台影视公共台/柳州公共台
贵州科教健康频道	guizoutv6	贵州科教健康频道/贵州科教健康/贵州电视台六频道/贵州电视台六/贵州电视台健康频道/贵州电视台健康/贵州台科教健康频道/贵州台科教健康/贵州6频道/贵州6/贵州六台/贵州六
邢台经济生活频道	xttv2	邢台经济生活频道/邢台经济生活/邢台电视台经济生活频道/邢台电视台经济生活/邢台电视台2/邢台台影视娱乐频道/邢台台影视娱乐/xttv2/邢台经济生活台/邢台经济频道/邢台经济/邢台生活
黑龙江少儿	hljtv7	黑龙江少儿/黑龙江电视台少儿频道/黑龙江电视台少儿/黑龙江7频道/黑龙江7/黑龙江电视7套/黑龙江电视7/黑龙江台少儿频道/黑龙江台少儿/黑龙江少儿频道/hljtv7/黑龙江少儿台/黑龙江七套/黑龙江七/黑龙江七频道
黑龙江考试	hljexam	黑龙江考试/黑龙江电视台考试频道/黑龙江电视台考试/龙视考试频道/龙视考试
黑龙江导视	hljdaoshi	黑龙江导视/黑龙江电视台导视频道/黑龙江电视台导视/龙视导视
哈尔滨娱乐频道	hrbtv4	哈尔滨娱乐频道/哈尔滨娱乐/哈尔滨电视台娱乐频道/哈尔滨电视台娱乐/哈尔滨台娱乐频道/哈尔滨台娱乐
河南新农村频道	hntv9	河南新农村频道/河南新农村/河南电视台新农村频道/河南电视台新农村/河南电视台9频道/河南电视台9/河南9套/河南9/河南九套/河南九/hntv9/hntv9新农村/河南九台
郑州影视戏曲频道	zhengzhoutv6	郑州影视戏曲频道/郑州影视戏曲/郑州电视台影视戏曲频道/郑州电视台影视戏曲/zztv6/zztv6影视频道/zztv6影视/郑视影视频道/郑视影视/郑州6套/郑州6/郑州电视台6套/郑州电视台6/郑州六套影视频道/郑州六套影视/郑州电视剧频道/郑州电视剧/郑州六套/郑州六/郑州影视频道/郑州影视/郑州六台/郑州影视台
洛阳公共频道	lytv2	洛阳公共频道/洛阳公共/洛阳电视台公共频道/洛阳电视台公共/洛阳台经济生活频道/洛阳台经济生活/洛阳经济频道/洛阳经济/洛阳生活频道/洛阳生活/洛阳三台/洛阳三/洛阳经济台/洛阳生活台
湖南电视剧频道	hunantv4	湖南电视剧频道/湖南电视剧/湖南电视台电视剧频道/湖南电视台电视剧/湖南电视台影视频道/湖南电视台影视/湖南影视频道预报/湖南影视频道/湖南影视/湖南影视台
常州都市频道	changzhou2	常州都市频道/常州都市/常州电视台都市频道/常州电视台都市/常州台都市频道/常州台都市/常州都市台
常州公共频道	changzhou4	常州公共频道/常州公共/常州电视台公共频道/常州电视台公共/常州台公共频道/常州台公共/常州公共台
抚顺教育频道	lnfs3	抚顺教育频道/抚顺教育/抚顺电视台教育频道/抚顺电视台教育/lnfs综合频道/lnfs综合/抚顺综合台/抚顺综合/抚顺电视台三套/抚顺电视台三/抚顺三台/抚顺三/抚顺三套/抚顺3台/抚顺3/抚顺3套/抚顺电视台雷锋频道/抚顺电视台雷锋
内蒙古宣传频道	nmgxc	内蒙古宣传频道/内蒙古宣传
山西影视频道	sxtv3	山西影视频道/山西影视/山西电视台影视频道/山西电视台影视/山西台影视频道/山西台影视/山西影视台
山西公共频道	sxtv5	山西公共频道/山西公共/山西电视台公共频道/山西电视台公共/山西台公共频道/山西台公共/山西公共台/山西公共卫视
山东少儿频道	sdtv6	山东少儿频道/山东少儿/山东电视台少儿频道/山东电视台少儿/sdtv第九少儿频道/sdtv第九少儿/山东第九少儿频道/山东第九少儿/山东电视台第九少儿频道/山东电视台第九少儿/山东台第九少儿频道/山东台第九少儿/sdtv少儿/山东少儿台
山东有线导视服务	dsfw	山东有线导视服务/山东有线导视/山东导视频道/山东导视
青岛青少旅游频道	sdqd6	青岛青少旅游频道/青岛青少旅游/青岛电视台青少旅游频道/青岛电视台青少旅游/qtv6青少旅游频道/qtv6青少旅游/qtv6/青岛台青少旅游频道/青岛台青少旅游/青岛电视台公共频道/青岛电视台公共/青岛青少旅游台/青岛电视台公共台
青岛党建频道	sdqd7	青岛党建频道/青岛党建/青岛电视台党建电视频道/青岛电视台党建电视/qtv7党建电视频道/qtv7党建电视/青岛党建电视频道/青岛党建电视/qtv7/青岛台党建电视频道/青岛台党建电视/qtv党建/青岛党建电视台/青岛七台/青岛七
济南生活频道	jntv5	济南生活频道/济南生活/济南电视台生活频道/济南电视台生活/jntv5生活频道/jntv5生活/jntv5/济南生活台
历城新闻综合	lcxw	历城新闻综合/历城电视台新闻综合频道/历城电视台新闻综合/历城电视台综合频道/历城电视台综合/历城新闻
历城影视频道	lcys	历城影视频道/历城影视/历城电视台影视频道/历城电视台影视
潍坊生活频道	sdwf3	潍坊生活频道/潍坊生活/潍坊电视台经济生活频道/潍坊电视台经济生活/sdwf3法制生活频道/sdwf3法制生活/潍坊法制生活频道/潍坊法制生活/潍坊3套/潍坊3/潍坊三套/潍坊三/潍坊经济/潍坊农业/潍坊三台
日照图文频道	rizhao4	日照图文频道/日照图文/日照电视台图文频道/日照电视台图文/日照影视频道/日照影视/日照影视台/日照电视台房车频道/日照电视台房车/日照房车频道/日照房车
泰安教科	tatv3	泰安教科/泰山电视台教育科学频道/泰山电视台教育科学/泰安台三套/泰安台三/泰安教科频道/泰安三套/泰安三/泰安教科台/泰安三台
莱阳电视台	sdly1	莱阳电视台/莱阳电视/山东莱阳电视台/山东莱阳电视/莱阳电视频道/莱阳电视台一套/莱阳电视台一/莱阳一台/莱阳一/莱阳台/莱阳/莱阳tv
新视觉体育高清频道	sitv_sports	新视觉体育高清频道/新视觉体育高清/新视觉体育频道高清
新视觉贝贝	sitv_children	新视觉贝贝
新视觉时尚	sitv_fashion	新视觉时尚
DOX雅趣	doxyaqupd	dox雅趣
点播影院	dianboyingyuan	点播影院
陕西五套	shxitv6	陕西五套/陕西五/陕西电视台公共政法频道/陕西电视台公共政法/陕视公共政法频道/陕视公共政法/陕西电视收视指南/陕西电视台5套/陕西电视台5/陕西公共政法频道/陕西公共政法/陕西台公共政法频道/陕西台公共政法/sxtvs5/陕西公共/陕西5套/陕西5/陕西5台/陕西五台
四川经济频道	sctv3	四川经济频道/四川经济/四川电视台经济频道/四川电视台经济/sctv3/sctv3经济频道/sctv3经济/四川电视台3套/四川电视台3/四川台经济频道/四川台经济/四川三套/四川三/四川3套/四川3/四川三台/四川3台/sctv3 财经频道/sctv3 财经/财经频道/财经
四川星空购物频道	sctv6	四川星空购物频道/四川星空购物/四川电视台星空购物频道/四川电视台星空购物/sctv6/sctv6星空购物频道/sctv6星空购物/四川电视收视指南/四川电视台6套/四川电视台6/四川台星空购物频道/四川台星空购物/四川体育频道/四川体育/四川六套/四川六/四川6套/四川6/四川第6频道/四川第6/四川购物频道/四川购物/星空购物/四川六台
成都美食天府	cdtv_7	成都美食天府/成都美食天府频道/cdtv7/cdtv7美食天府/cdtv7 美食天府/美食天府/天府美食
浙江钱江都市	zjtv2	浙江钱江都市/浙江电视台钱江都市频道/浙江电视台钱江都市/浙江卫视钱江都市频道/浙江卫视钱江都市/浙江二台钱江都市频道/浙江二台钱江都市/钱江都市频道/钱江都市/ztv2/钱江频道/钱江/浙江二台/浙江二
浙江卫视亚洲	zjtv9	浙江卫视亚洲
杭州综合频道	htv1	杭州综合频道/杭州综合/杭州电视台综合频道/杭州电视台综合/杭州台综合频道/杭州台综合/杭州一套/杭州一/杭州新闻综合频道/杭州新闻综合/htv1/杭州1套/杭州1/htv1杭州综合/杭州一台
宁波社会生活	nbtv2	宁波社会生活/宁波电视台社会生活频道/宁波电视台社会生活/宁波经济生活频道/宁波经济生活/宁波台经济生活频道/宁波台经济生活/宁波二套/宁波二/宁波2套/宁波2/宁波二台/宁波2台/宁波社会生活频道/nbtv2/宁波电视台经济生活频道/宁波电视台经济生活/宁波经济生活台
瓯江先锋频道	wztv5	瓯江先锋频道/瓯江先锋/温州电视台瓯江先锋频道/温州电视台瓯江先锋/温州5套/温州5/温州五套/温州五/温州5台/温州五台
湖州新闻综合	huzhoutv1	湖州新闻综合/湖州电视台新闻综合频道/湖州电视台新闻综合/湖州台新闻综合频道/湖州台新闻综合/湖州新闻综合台/湖州综合频道/湖州综合/湖州新闻频道/湖州新闻
青海综合频道	qhtv3	青海综合频道/青海综合/青海电视台综合频道/青海电视台综合/青海综合卫视/青海综合台/青海综合电视台/青海综合电视
威海图文频道	whzy	威海图文频道/威海图文/威海电视台图文频道/威海电视台图文
烟台电影	yantai5	烟台电影/烟台电视台电影频道/烟台电视台电影/烟台5台/烟台5/烟台5套/烟台电影频道/烟台五套/烟台五
西安白鸽都市频道	xian2	西安白鸽都市频道/西安白鸽都市/西安电视台白鸽都市频道/西安电视台白鸽都市/西安2台/西安2/西安2套/西安二套/西安二/西安二台/西安都市频道/西安都市/白鸽都市频道/白鸽都市/xatv2
CHC高清电影	chc3	chc高清电影/chc高清频道/chc高清/chc高清影院/chc高清电影台/chc电影/华诚高清/华诚高清电影/chc高清影视/chc电影高清
爱家购物	bamc9	爱家购物/北京电话台爱家购物频道/北京电话台爱家购物/btv爱家购物/北京爱家购物
家政频道	family_channel	家政频道/家政/付费频道家政频道/付费频道家政/数字电视家政频道/数字电视家政/家政服务频道/家政服务
新动漫	dongman	新动漫/新动漫频道/chc新动漫
会展频道	huizahn	会展频道/会展/广东会展频道/广东会展/广东电视台会展频道/广东电视台会展/汽车会展频道/汽车会展/广东汽车会展
北大荒公共频道	bdhgg	北大荒公共频道/北大荒公共/北大荒电视台公共频道/北大荒电视台公共/北大荒公共台/北大荒公共电视台/北大荒公共电视
舟山公共频道	zjzs_life	舟山公共频道/舟山公共/舟山电视台经济生活频道/舟山电视台经济生活/舟山经济生活频道/舟山经济生活/舟山台经济频道/舟山台经济/舟山经济生活台
高清综艺频道地区	szthm_yule2	高清综艺频道地区/综艺频道地区高清
黄河国际频道	china_hhtv	黄河国际频道/黄河国际/中国黄河电视台/中国黄河电视/中国黄河电视台国际台/中国黄河电视台国际/中国黄河频道/中国黄河
翡翠台	tvb1	翡翠台/翡翠/tvb翡翠台/tvb翡翠/香港翡翠台/香港翡翠/无线翡翠
广州购物	gztvmall	广州购物
国家地理频道	ngc_cn	国家地理频道/国家地理/ngc/nat geo channel/国家地理台/national geogrphic
运城公共频道	yctv2	运城公共频道/运城公共/运城电视台二套/运城电视台二/运城2套/运城2/运城电视台2套/运城电视台2/运城二套/运城二/运城二台
EUROSPORT	eurosport	eurosport/欧洲体育频道/欧洲体育/欧洲体育台/euro sports/歐洲體育hd頻道 (eurosport channel)/eurosport 1 hd/歐洲體育台/歐洲體育
高清点点亲子	hdddqz	高清点点亲子/高清点点亲子频道/nvod高清点点亲子/nvod 高清点点亲子/点点亲子高清
星元新知	xyxz	星元新知
星元成长	xycz	星元成长
星元旅行	xylx	星元旅行/星元旅游
IPTV6PLUS	iptv6	iptv6plus
IPTV野外	iptvyw	iptv野外
唐山生活频道	tssv2	唐山生活频道/唐山生活/唐山电视台生活服务频道/唐山电视台生活服务/唐山2/唐山二台/唐山二
德阳公共频道	scdytv2	德阳公共频道/德阳公共/德阳电视台公共频道/德阳电视台公共
德阳都市频道	scdytv3	德阳都市频道/德阳都市/德阳电视台都市频道/德阳电视台都市/德阳影视频道/德阳影视/德阳二套/德阳二/德阳二台
鞍山新闻综合频道	ahshantv1	鞍山新闻综合频道/鞍山新闻综合/鞍山电视台新闻综合频道/鞍山电视台新闻综合/鞍山综合频道/鞍山综合
鞍山娱乐频道	ahshantv3	鞍山娱乐频道/鞍山娱乐/鞍山电视台娱乐频道/鞍山电视台娱乐
鞍山新闻集锦频道	ahshantv6	鞍山新闻集锦频道/鞍山新闻集锦/鞍山电视台新闻集锦频道/鞍山电视台新闻集锦
本溪一套	bxtv1	本溪一套/本溪一/本溪电视台新闻频道/本溪电视台新闻/本溪1/本溪一台
本溪二套	bxtv2	本溪二套/本溪二/本溪电视台文体频道/本溪电视台文体/本溪2/本溪二台
锦州一套	jinzhoutv1	锦州一套/锦州一/锦州电视台新闻频道/锦州电视台新闻/锦州电视台1/锦州一台
锦州二套	jinzhoutv2	锦州二套/锦州二/锦州电视台都市教育频道/锦州电视台都市教育/锦州电视台2/锦州二台
葫芦岛新闻综合	hldtv1	葫芦岛新闻综合/葫芦岛电视台新闻综合频道/葫芦岛电视台新闻综合/葫芦岛一套/葫芦岛一/葫芦岛1/葫芦岛一台
鹤岗综合频道	hgtv1	鹤岗综合频道/鹤岗综合/鹤岗电视台新闻综合频道/鹤岗电视台新闻综合/鹤岗综合台
镇江资讯频道	zhenjiangtv3	镇江资讯频道/镇江资讯/镇江电视台城市资讯频道/镇江电视台城市资讯/镇江城市资讯频道/镇江城市资讯/镇江资讯台
镇江影视频道	zhenjiangtv4	镇江影视频道/镇江影视/镇江电视台影视购物频道/镇江电视台影视购物/镇江影视台
如皋党建频道	rgdj	如皋党建频道/如皋党建/如皋电视台党建频道/如皋电视台党建/如皋党建台
芜湖徽商频道	wuhutv3	芜湖徽商频道/芜湖徽商/芜湖电视台徽商频道/芜湖电视台徽商/芜湖公共徽商
宜宾新闻综合频道	scybtv1	宜宾新闻综合频道/宜宾新闻综合/宜宾电视台新闻综合频道/宜宾电视台新闻综合/宜宾综合频道/宜宾综合
宜宾公共生活频道	scybtv2	宜宾公共生活频道/宜宾公共生活/宜宾电视台公共生活频道/宜宾电视台公共生活/宜宾公共
抚州一套	jxfztv1	抚州一套/抚州一/抚州电视台新闻综合频道/抚州电视台新闻综合/抚州一台
抚州二套	jxfztv2	抚州二套/抚州二/抚州电视台公共频道/抚州电视台公共/抚州影视娱乐频道/抚州影视娱乐/抚州影视娱乐台/抚州二台
济宁党建频道	sdjndj	济宁党建频道/济宁党建/济宁电视台党建频道/济宁电视台党建
济宁中区电影娱乐	sdjnzq2	济宁中区电影娱乐/济宁中区电影娱乐频道/济宁中区电影娱乐台
荆门农谷频道	hbjmtv2	荆门农谷频道/荆门农谷/荆门电视台农谷频道/荆门电视台农谷/荆门农谷台
滨州公共频道	binzhoutv2	滨州公共频道/滨州公共/滨州电视台公共频道/滨州电视台公共/滨州公共太
安阳图文频道	aytv4	安阳图文频道/安阳图文/安阳电视台图文生活频道/安阳电视台图文生活/安阳电视剧/安阳图文台
咸阳教育电视台	sxxyetv	咸阳教育电视台/咸阳教育电视
六安公共频道	liuantv2	六安公共频道/六安公共/六安电视台公共频道/六安电视台公共/六安公共台
炫酷动漫	xkdongman	炫酷动漫
宜兴新闻频道	yxxinwen	宜兴新闻频道/宜兴新闻/宜兴电视台新闻频道/宜兴电视台新闻/宜兴新闻台
鄂尔多斯城市生活	eedstv4	鄂尔多斯城市生活/鄂尔多斯电视台城市生活频道/鄂尔多斯电视台城市生活/鄂尔多斯3/鄂尔多斯三台/鄂尔多斯三
营口公共频道	ykotv2	营口公共频道/营口公共/营口电视台社会生活频道/营口电视台社会生活/营口电视台二套/营口电视台二/营口2/营口二台/营口二
营口影视频道	ykotv3	营口影视频道/营口影视/营口电视台文艺影视频道/营口电视台文艺影视/营口电视台三套/营口电视台三/营口3/营口三台/营口三
平顶山新闻综合	pdstv1	平顶山新闻综合/平顶山电视台新闻综合频道/平顶山电视台新闻综合/平顶山新闻频道/平顶山新闻
平顶山公共频道	pdstv3	平顶山公共频道/平顶山公共/平顶山电视台公共频道/平顶山电视台公共/平顶山公共台
泸州新闻频道	kuzhoutv1	泸州新闻频道/泸州新闻/泸州电视台新闻综合频道/泸州电视台新闻综合/泸州综合/泸州1/泸州一套/泸州一/泸州综合台/泸州一台
商丘公共频道	sqtvca2	商丘公共频道/商丘公共/商丘电视台公共频道/商丘电视台公共/商丘公共台
临夏综合频道	linxiatv1	临夏综合频道/临夏综合/临夏电视台综合频道/临夏电视台综合
贵港公共频道	ggtv2	贵港公共频道/贵港公共/贵港电视台公共频道/贵港电视台公共
丽江公共频道	lijiangtv2	丽江公共频道/丽江公共/丽江电视台公共频道/丽江电视台公共/丽江公共台
美食养生	meishiys	美食养生
凉山公共频道	liangstv2	凉山公共频道/凉山公共/凉山电视台公共频道/凉山电视台公共/凉山公共台
毕节试验区新闻台	bjtv1	毕节试验区新闻台/毕节试验区新闻/毕节试验区电视台新闻频道/毕节试验区电视台新闻
毕节试验区娱乐台	bjtv3	毕节试验区娱乐台/毕节试验区娱乐/毕节试验区电视台娱乐频道/毕节试验区电视台娱乐
雅安经视频道	yaantv2	雅安经视频道/雅安经视/雅安电视台经视频道/雅安电视台经视/雅安电视台经济频道/雅安电视台经济/雅安经济频道/雅安经济/雅安经济台
汕尾综合频道	swtv1	汕尾综合频道/汕尾综合/汕尾电视台综合频道/汕尾电视台综合/汕尾一套/汕尾一/汕尾一台
酒泉综合频道	jiuquantv1	酒泉综合频道/酒泉综合/酒泉电视台综合频道/酒泉电视台综合/酒泉综合台
江阴第一房产频道	jsjytv3	江阴第一房产频道/江阴第一房产/江阴电视台第一房产频道/江阴电视台第一房产/江阴电视台电影频道/江阴电视台电影/江阴电影台/江阴电影
宜昌公共频道	yichangtv2	宜昌公共频道/宜昌公共/宜昌电视台公共频道/宜昌电视台公共/宜昌公共台
河池科教生活频道	hchtv2	河池科教生活频道/河池科教生活/河池电视台科教生活频道/河池电视台科教生活/河池电视台教育频道/河池电视台教育/河池科教频道/河池科教/河池科教台
凤凰卫视香港台	phoenixhk	凤凰卫视香港台/凤凰卫视香港/凤凰香港台/凤凰香港
渭南都市频道	weinands	渭南都市频道/渭南都市/渭南3/渭南三台/渭南三
渭南公共频道	weinangg	渭南公共频道/渭南公共/渭南4/渭南四台/渭南四/渭南公共台
北京影视频道	btv4	北京影视频道/北京影视/北京电视台影视频道/北京电视台影视/btv4/btv4台/btv4套/btv电影/btv影视/btv影视频道/北京电视台四套/北京电视台四/北京电影台/北京电影/北京四台/北京四/北京四套/北京台影视频道/北京台影视/北京影视台
北京财经频道	btv5	北京财经频道/北京财经/北京电视台财经频道/北京电视台财经/btv5/btv5台/btv5套/btv财经/btv财经频道/北京电视台五套/北京电视台五/北京台财经频道/北京台财经/北京五台/北京五/北京五套
福建旅游频道	fjtv6	福建旅游频道/福建旅游/福建电视台旅游频道/福建电视台旅游/福建tv6频道/福建tv6/福建都市生活频道/福建都市生活/福建台都市频道/福建台都市/fjtv6/福建6都市时尚/福建6综艺/福建6都市/福建都市频道/福建都市
福州影视频道	fztv2	福州影视频道/福州影视/福州电视台影视频道/福州电视台影视/福州电视台2套/福州电视台2/福州电视台二套/福州电视台二/福州电视影视频道/福州电视影视/fztv2/福州二台/福州二
甘肃经济频道	gstv2	甘肃经济频道/甘肃经济/甘肃电视台经济频道/甘肃电视台经济/甘肃台经济频道/甘肃台经济/甘肃经济电视台/甘肃经济电视
天水新闻综合频道	tstv1	天水新闻综合频道/天水新闻综合/天水电视台新闻综合频道/天水电视台新闻综合/天水新闻台/天水新闻/天水综合频道/天水综合/天水新闻频道/天水新闻综合电视台/天水新闻综合电视
广东体育频道	gdtv3	广东体育频道/广东体育/广东电视台体育频道/广东电视台体育/gdtv体育频道/gdtv体育/广东电视体育频道/广东电视体育/广东电视体育台/广东台体育频道/广东台体育/广东体育台/gdtvsports/广东省体育频道/广东省体育
广东公共频道	gdtv4	广东公共频道/广东公共/广东电视台公共频道/广东电视台公共/gdtv公共频道/gdtv公共/广东电视公共频道/广东电视公共/广东台公共频道/广东台公共/gdtv4/广东省公共频道/广东省公共
深视都市频道	sztv2	深视都市频道/深视都市/深圳电视台都市频道/深圳电视台都市/深视一套/深视一/深圳1套/深圳1/深圳1套都市频道/深圳1套都市/深圳都市频道/深圳都市/深圳一台/深圳一/sztv1/深圳一套/深圳1台
深视公共频道	sztv8	深视公共频道/深视公共/深圳电视台公共频道/深圳电视台公共/深视七套/深视七/深圳7套/深圳7/深圳7套公共频道/深圳7套公共/深圳公共频道/深圳公共/深圳七台/深圳七/sztv7/深圳七套/深圳7台
广州经济频道	gztv6	广州经济频道/广州经济/广州电视台经济频道/广州电视台经济/广视经济频道/广视经济/广州经济台/广州卫视经济频道/广州卫视经济/gztv6
珠海西岸频道	zhxian	珠海西岸频道/珠海西岸/珠海电视台西岸频道/珠海电视台西岸/珠海4/珠海四台/珠海四
中山台综合频道	gdzs1	中山台综合频道/中山台综合/中山电视台综合频道/中山电视台综合/广东中山电视台综合频道/广东中山电视台综合/gdzs1/中山综合频道/中山综合
湛江综合频道	gdzj1	湛江综合频道/湛江综合/湛江电视台综合频道/湛江电视台综合/广东湛江电视台综合频道/广东湛江电视台综合/湛江电台新闻综合频道/湛江电台新闻综合/gdzj1/广东湛江综合频道/广东湛江综合
肇庆新闻综合	gdzq1	肇庆新闻综合/肇庆电视台新闻综合频道/肇庆电视台新闻综合/广东肇庆电视台新闻综合频道/广东肇庆电视台新闻综合/肇庆综合频道/肇庆综合/肇庆新闻综合频道
肇庆公共频道	gdzq2	肇庆公共频道/肇庆公共/肇庆电视台公共频道/肇庆电视台公共/广东肇庆电视台公共频道/广东肇庆电视台公共/gdzq2
广西国际频道	gxgj	广西国际频道/广西国际/广西电视台国际频道/广西电视台国际
安顺新闻台	anshun1	安顺新闻台/安顺新闻/安顺电视台新闻频道/安顺电视台新闻/贵州安顺电视台/贵州安顺电视
河北科教频道	hebei5	河北科教频道/河北科教/河北电视台少儿科教频道/河北电视台少儿科教/河北台科教频道/河北台科教/河北台少儿科教频道/河北台少儿科教/河北台少儿频道/河北台少儿/河北少儿科教/河北少儿/hebtv5/河北五套/河北五/河北5套/河北5/少儿科教 河北电视台/少儿科教 河北电视/河北科教台/河北五台
河北杂技频道	hbzj	河北杂技频道/河北杂技
河北收视指南频道	hbsszn	河北收视指南频道/河北收视指南
保定文化频道	bdtv3	保定文化频道/保定文化/保定电视台文化娱乐频道/保定电视台文化娱乐/bdtv3/保定台生活健康频道/保定台生活健康/保定生活健康/保定健康频道/保定健康/保定电视台快乐3频道/保定电视台快乐3/保定三台/保定三/保定3台/保定3/保定文化娱乐频道/保定文化娱乐
大庆教育频道	dqkjtv	大庆教育频道/大庆教育/大庆电视台教育频道/大庆电视台教育/大庆科教台/大庆科教
河南电视剧频道	hntv5	河南电视剧频道/河南电视剧/河南电视台电视剧频道/河南电视台电视剧/河南5套/河南5/河南五套/河南五/河南电视剧5/河南电视剧频道5/河南台电视剧频道/河南台电视剧/hntv5/hntv5电视剧/河南电视台5/河南五台
郑州商都频道	zhengzhoutv2	郑州商都频道/郑州商都/郑州电视台商都频道/郑州电视台商都/zztv2/郑州2台/郑州2/郑州2套/郑州电视台2套/郑州电视台2/郑州二台/郑州二/郑视商都频道/郑视商都/郑州二套/郑州商都台
湖北卫视香港	hubei1_hk	湖北卫视香港
武汉外语频道	whtv6	武汉外语频道/武汉外语/武汉电视台外语频道/武汉电视台外语/武汉6台/武汉6/武汉6套/武汉电视台六套/武汉电视台六/武汉六套/武汉六/whtv6/武汉六台/武汉电视台外语台
武汉广通购物频道	whtv8	武汉广通购物频道/武汉广通购物/武汉电视台消费指南频道/武汉电视台消费指南/武汉八套/武汉八/武汉电视台八套/武汉电视台八/武汉电视台数字消费指南/武汉消费指南/whtv广通购物/武汉八台/武汉消费台/武汉消费
江苏综艺频道	jstv2	江苏综艺频道/江苏综艺/江苏电视台综艺频道/江苏电视台综艺/江苏电视综艺频道/江苏电视综艺/江苏文艺频道/江苏文艺/江苏综艺台
苏州社会经济频道	suzhoutv2	苏州社会经济频道/苏州社会经济/苏州电视台社会经济频道/苏州电视台社会经济/苏州台社会经济频道/苏州台社会经济/苏州电视台二套社会经济频道/苏州电视台二套社会经济/苏州二套/苏州二/苏州2套/苏州2/苏州二台社会经济频道/苏州二台社会经济/苏州二台
苏州生活资讯频道	suzhoutv5	苏州生活资讯频道/苏州生活资讯/苏州电视台生活资讯频道/苏州电视台生活资讯/苏州台生活资讯频道/苏州台生活资讯/苏州五套/苏州五/苏州5套/苏州5
常熟新闻综合频道	changshu1	常熟新闻综合频道/常熟新闻综合/常熟电视台新闻综合频道/常熟电视台新闻综合/常熟综合频道/常熟综合
无锡影视频道	wuxi6	无锡影视频道/无锡影视/无锡电视台影视频道/无锡电视台影视/无锡台影视频道/无锡台影视/无锡影视台
铁岭生活频道	tieling2	铁岭生活频道/铁岭生活/铁岭电视台生活频道/铁岭电视台生活/铁视2套/铁视2/铁岭二台/铁岭二/铁岭2台/铁岭2/铁岭二套/铁视二套/铁视二
宁夏台少儿频道	nxtv5	宁夏台少儿频道/宁夏台少儿/宁夏电视台少儿频道/宁夏电视台少儿/宁夏少儿频道/宁夏少儿/宁夏少儿台
太原教育台	tyetv	太原教育台/太原教育
太原影视频道	sxtytv4	太原影视频道/太原影视/山西太原电视台影视频道/山西太原电视台影视/太原电视台影视频道/太原电视台影视/太原4套/太原4/太原四套/太原四/太原4台/太原四台
山东齐鲁频道	sdtv2	山东齐鲁频道/山东齐鲁/山东电视台齐鲁频道/山东电视台齐鲁/sdtv齐鲁频道/sdtv齐鲁/山东台齐鲁频道/山东台齐鲁/齐鲁台/齐鲁/山东电视齐鲁频道/山东电视齐鲁/山东卫视齐鲁频道/山东卫视齐鲁/齐鲁频道
青岛新闻综合频道	sdqd1	青岛新闻综合频道/青岛新闻综合/青岛电视台新闻综合频道/青岛电视台新闻综合/qtv1新闻综合频道/qtv1新闻综合/青岛1台/青岛1/qtv1/青岛综合频道/青岛综合/青岛新闻频道/青岛新闻/青岛一套/青岛一/青岛一台/青岛1套/青岛台新闻综合频道/青岛台新闻综合/青岛新闻综合台/青岛台
青岛都市频道	sdqd5	青岛都市频道/青岛都市/青岛电视台都市频道/青岛电视台都市/qtv5都市频道/qtv5都市/qtv5体育综艺频道/qtv5体育综艺/青岛五台/青岛五/青岛五套/青岛5台/青岛5/青岛5套/qtv5/青岛台都市频道/青岛台都市/青岛都市台
济南娱乐频道	jntv4	济南娱乐频道/济南娱乐/济南电视台娱乐频道/济南电视台娱乐/jntv4娱乐频道/jntv4娱乐/jntv4/济南娱乐台
泰安图文	tatv4	泰安图文/泰安电视台旅游文化频道/泰安电视台旅游文化/泰安台四套/泰安台四/泰安四台/泰安四
东方卫视	dongfang1	东方卫视/东方电视台/东方电视/东方卫视频道/东方卫视台/东方卫星电视/东方卫星频道/东方卫星/上海东方电视台/上海东方电视/上海东方台/上海东方/上海东方卫视/上海东方卫视电视台/上海东方卫视电视/上海卫视/东方台/东方/番茄台/番茄/上海台/东方tv
上海星尚频道	shhai3	上海星尚频道/上海星尚/上海电视台星尚频道/上海电视台星尚
上视电视剧频道	shhai4	上视电视剧频道/上视电视剧/上海电视台电视剧频道/上海电视台电视剧/上海电视剧电视台/上海电视剧电视/上海电视剧频道/上海电视剧/上海台电视剧频道/上海台电视剧/上视电视台电视剧频道/上视电视台电视剧/上海电视台上海电视剧频道/上海电视台上海电视剧
上海新视觉剧场高清频道	sitv_movies	上海新视觉剧场高清频道/上海新视觉剧场高清/上海新视觉剧场频道高清/sitv新视觉剧场高清频道/sitv新视觉剧场高清/新视觉剧场/新视觉高清剧场/新视觉影视/新视觉hd剧场
新视觉旅游	sitv_travel	新视觉旅游
互动导视	hudong	互动导视
东方购物二套	dongfanggw2	东方购物二套/东方购物二/东方购物2
陕西三套	shxitv4	陕西三套/陕西三/陕西电视台家庭生活频道/陕西电视台家庭生活/陕视家庭生活频道/陕视家庭生活/陕西/陕西电视台3套/陕西电视台3/陕西家庭生活频道/陕西家庭生活/陕西台家庭生活频道/陕西台家庭生活/陕西3套/陕西3/陕西三台/陕西3台/sxtvs3/陕西生活
四川新闻资讯频道	sctv4	四川新闻资讯频道/四川新闻资讯/四川电视台新闻资讯频道/四川电视台新闻资讯/sctv4/sctv4新闻频道/sctv4新闻/四川电视台4套/四川电视台4/四川台新闻资讯频道/四川台新闻资讯/四川新闻咨讯频道/四川新闻咨讯/四川四套/四川四/四川4套/四川4/四川新闻频道/四川新闻/四川四台
天津科教频道	tjtv7	天津科教频道/天津科教/天津电视台科教频道/天津电视台科教/天津电视科教频道/天津电视科教/tjtv6/天津六套/天津六/天津6套/天津6/天津六台/天津6台/天津六套科教频道/天津六套科教/天津科教台
XJTV2	xjtv2	xjtv2/新疆电视台维语新闻综合频道/新疆电视台维语新闻综合/新疆电视台第二频道维语新闻综合频道/新疆电视台第二频道维语新闻综合/新疆电视台二频道/新疆电视台二/新疆电视台二套维语新闻综合频道/新疆电视台二套维语新闻综合/新疆台2频道/新疆台2/新疆维语新闻综合频道/新疆维语新闻综合/新疆二台/新疆二/新疆2台/新疆2/新疆2套/新疆二套/新疆维吾尔语/维吾尔语新闻频道/维吾尔语新闻/新疆卫视维语/新疆卫视2/新疆维语新闻
昆明阳光频道	kmtv2	昆明阳光频道/昆明阳光/昆明电视台阳光频道/昆明电视台阳光/kmtv2/昆明生活/昆明二套/昆明二/昆明2套/昆明2/昆明2台/昆明二台/昆明电视台生活频道/昆明电视台生活/昆明生活频道/昆明经济生活频道/昆明经济生活/昆明经济频道/昆明经济
昆明财富频道	kmtv4	昆明财富频道/昆明财富/昆明电视台财富频道/昆明电视台财富/kmtv4/昆明体育娱乐频道/昆明体育娱乐/昆明体育/昆明四套/昆明四/昆明4套/昆明4/昆明四台/昆明4台/昆明电视台体育频道/昆明电视台体育/昆明体育频道
浙江影视娱乐	zjtv5	浙江影视娱乐/浙江电视台影视娱乐频道/浙江电视台影视娱乐/浙江台影视娱乐/浙江台影视娱乐频道/浙江影视文化频道/浙江影视文化/浙江卫视5套/浙江卫视5/浙江五套影视文化频道/浙江五套影视文化/浙江影视频道/浙江影视/ztv影视娱乐/ztv5
浙江公共新闻	zjtv7	浙江公共新闻/浙江电视台公共新闻频道/浙江电视台公共新闻/cztv7/浙江公共频道/浙江公共/浙江公共·新农村频道/浙江公共·新农村/浙江新农村频道/浙江新农村/ztv7/浙江公共新农村频道/浙江公共新农村/浙江新闻频道/浙江新闻/浙江公共台
浙江卫视欧洲	zjtv13	浙江卫视欧洲
温州都市生活	wztv3	温州都市生活/温州电视台都市生活频道/温州电视台都市生活/温州台都市生活频道/温州台都市生活/温州都市频道/温州都市/温州生活频道/温州生活/温州3台/温州3/温州都市生活台/温州都市台/温州生活台/温州三台/温州三
金华新闻综合	jinhuatv1	金华新闻综合/金华电视台新闻综合频道/金华电视台新闻综合/金华台新闻综合频道/金华台新闻综合/金华综合台/金华综合/金华综合频道/金华新闻频道/金华新闻
临汾三套	linfentv3	临汾三套/临汾三/临汾电视台三套/临汾电视台三/临汾3套/临汾3/临汾台三套/临汾台三/临汾3台/临汾三台/临汾科学教育频道/临汾科学教育/临汾科教频道/临汾科教/linfen3
枣庄公共频道	zaozhuang2	枣庄公共频道/枣庄公共/枣庄电视台公共频道/枣庄电视台公共/枣庄台公共频道/枣庄台公共/枣庄公共电视台/枣庄公共电视/枣庄公共台
延边TV1	ybtv1	延边tv1/延边电视台新闻综合频道/延边电视台新闻综合
银川台公共频道	yinchuang3	银川台公共频道/银川台公共/银川电视台公共频道/银川电视台公共/银川公共频道/银川公共/银川公共台
信阳平桥频道	xinyang2	信阳平桥频道/信阳平桥/信阳电视台平桥频道/信阳电视台平桥/信阳平桥台
石家庄一套	shijiazhuang1	石家庄一套/石家庄一/石家庄电视台新闻综合频道/石家庄电视台新闻综合/石家庄电视台1/石家庄电视台1频道/石家庄电视台1套/石家庄电视台一套/石家庄电视台一/石家庄新闻综合频道/石家庄新闻综合/石家庄1套/石家庄1/石家庄一台/石家庄1台/石家庄新闻频道/石家庄新闻
石家庄二套	shijiazhuang2	石家庄二套/石家庄二/石家庄电视台娱乐频道/石家庄电视台娱乐/石家庄电视台2/石家庄电视台2频道/石家庄电视台2套/石家庄电视台二套/石家庄电视台二/石家庄娱乐/石家庄2套/石家庄2/石家庄二台/石家庄娱乐台
烟台经济生活	yantai2	烟台经济生活/烟台电视台经济生活频道/烟台电视台经济生活/烟台2台/烟台2/烟台2套/烟台二套/烟台二/烟台经济生活频道/yttv2/烟台经济频道/烟台经济/烟台生活频道/烟台生活/ytv2/烟台经济生活台/烟台二台
烟台都市文体	yantai4	烟台都市文体/烟台电视台都市文体频道/烟台电视台都市文体/烟台4台/烟台4/烟台4套/烟台都市文体频道/yttv4/烟台四/ytv4/烟台都市文体台/烟台四台
西安商务资迅频道	xian3	西安商务资迅频道/西安商务资迅/西安电视台商务资讯频道/西安电视台商务资讯/西安3台/西安3/西安3套/西安三套/西安三/西安商务资讯频道/西安商务资讯/西安电视台3套商务资讯频道/西安电视台3套商务资讯/xatv3/西安三台
南昌公共频道	nanchang2	南昌公共频道/南昌公共/南昌电视台公共频道/南昌电视台公共/南昌公共台/南昌4/nctv4/南昌电视台4/南昌四台/南昌四
导视频道	ds	导视频道/导视/滁州高清导视/付费节目指南/日照导视/浙江网视/铜川电视指南/南阳导视/温洲导视/96371服务/节目导视/集团导视高清/数字电视导航/数字电视服务/枣庄数字导视/健康导视hd/数字导视/电视导播/宁波华数/菏泽数字电视导视/广电网络/导视信息/itv导视/荆州导视/晋城导视/有线导视/漳州导视/铁岭导视/视事通导视/导视综合/江夏有线/潮州宣传频道/潮州宣传/固安导视
歌华导视	ghdaoshi	歌华导视
澳亚卫视	mastv1	澳亚卫视/澳门澳亚卫视/澳亚卫视中文台/澳亚卫视中文/澳门卫视澳亚台/澳门卫视澳亚/澳亚卫视台
广州气象频道	gz_weather_tv	广州气象频道/广州气象/应急气象/广东应急气象
高清精选	hsgqjx	高清精选/华数高清精选/华数综合频道/华数综合/高清娱乐频道/高清娱乐/精选高清
TVB8	tvb8	tvb8/tvb8电视台/tvb8电视/tvb8频道/香港无线8
TVB星河频道	tvb9	tvb星河频道/tvb星河/星河频道/星河/星河台/tvb星河频道台/tvb xinghe/tvbs星河频道/tvbs星河/tvb星河卫视
卫视音乐	channel_v_cn	卫视音乐/channel [v]/星空音乐频道/星空音乐/channel v音乐台/channel v音乐/channel [v] mainland china/channel v/[v]音乐台/[v]音乐/channel【v】/[v] china/channel [v] 中國/channel [v] 中國大陸/音乐电视台/音乐电视
天鹅购物	swango	天鹅购物/哈尔滨天鹅购物频道/哈尔滨天鹅购物
炫动3D	hs3d	炫动3d/华数炫动3d/高清3d综艺
IPTV5PLUS	iptv5	iptv5plus
乐居吴江频道	wjtv4	乐居吴江频道/乐居吴江/吴江电影资讯频道/吴江电影资讯
NVOD 4K	nvod4k	nvod 4k
徐州文艺影视	xztv3	徐州文艺影视/徐州电视台文艺影视/徐州·3
三亚新闻综合频道	hnsytv1	三亚新闻综合频道/三亚新闻综合/三亚电视台新闻综合频道/三亚电视台新闻综合/三亚电视台1/三亚一套/三亚一/三亚电视台/三亚电视/三亚一台/三亚1套/三亚1/三亚tv
喜剧影院	xjyy	喜剧影院
睛彩江西	jcjxpd	睛彩江西
呼伦贝尔新闻综合	hlbrtv1	呼伦贝尔新闻综合/呼伦贝尔电视台新闻综合频道/呼伦贝尔电视台新闻综合/呼伦贝尔1
扬州江都频道	yzjiangdu	扬州江都频道/扬州江都/扬州江都台
唐山新闻频道	tssv1	唐山新闻频道/唐山新闻/唐山电视台新闻综合频道/唐山电视台新闻综合/唐山1/唐山一台/唐山一
揭阳综合频道	gdjytv1	揭阳综合频道/揭阳综合/揭阳电视台综合频道/揭阳电视台综合
九江三套	jxjjtv3	九江三套/九江三/九江电视台科教法制频道/九江电视台科教法制/jjtv3
山西导视	sxds	山西导视
连云港综合频道	lyg1	连云港综合频道/连云港综合/连云港电视台新闻综合频道/连云港电视台新闻综合
盐城三套	yanchengtv3	盐城三套/盐城三/盐城电视台三套/盐城电视台三/盐城电视台城市公共频道/盐城电视台城市公共/盐城城市公共/盐城城市公共台
乌鲁木齐新闻综合	utv1	乌鲁木齐新闻综合/乌鲁木齐电视台新闻综合频道/乌鲁木齐电视台新闻综合/乌鲁木齐台1/utv1/乌鲁木齐台一台/乌鲁木齐台一
乌鲁木齐影视频道	utv3	乌鲁木齐影视频道/乌鲁木齐影视/乌鲁木齐电视台影视频道/乌鲁木齐电视台影视/乌鲁木齐台3/utv3/乌鲁木齐台三台/乌鲁木齐台三
聊城水城频道	lctv4	聊城水城频道/聊城水城/聊城电视台水城频道/聊城电视台水城/lctv4/聊城图文频道/聊城图文
邯郸新闻频道	hdtv_1	邯郸新闻频道/邯郸新闻/邯郸新闻综合频道/邯郸新闻综合/邯郸电视台1
承德电视台3	chengdetv3	承德电视台3/承德电视台旅游文化频道/承德电视台旅游文化/承德电视台影视剧频道/承德电视台影视剧/承德影视剧频道/承德影视剧/承德旅游文化
松原影视频道	sytv3	松原影视频道/松原影视/松原电视台少儿影视频道/松原电视台少儿影视/sytv3/松原少儿影视台/松原少儿影视
淮安新闻频道	hatv1	淮安新闻频道/淮安新闻/淮安电视台新闻综合频道/淮安电视台新闻综合/淮安新闻综合/淮安新闻台
淮安娱乐频道	hatv3	淮安娱乐频道/淮安娱乐/淮安电视台影视娱乐频道/淮安电视台影视娱乐/淮安影视娱乐/淮安娱乐台
南通社教频道频道	nttv2	南通社教频道频道/南通社教频道/南通电视台社教综合频道/南通电视台社教综合/南通二套/南通二/南通二台/南通社教台/南通社教
桂林科教旅游频道	glkjly	桂林科教旅游频道/桂林科教旅游/桂林电视台科教旅游频道/桂林电视台科教旅游/桂林科教旅游台
如皋文化频道	rgjywh	如皋文化频道/如皋文化/如皋电视台文化频道/如皋电视台文化/如皋文化台
淮南新闻综合	huainantv1	淮南新闻综合/淮南电视台新闻频道/淮南电视台新闻/淮南一套/淮南一/淮南一台
淮南时尚娱乐	huainantv3	淮南时尚娱乐/淮南电视台时尚娱乐频道/淮南电视台时尚娱乐/淮南电视台影视频道/淮南电视台影视/淮南三套/淮南三/淮南三台
萍乡赣西频道	pxitv2	萍乡赣西频道/萍乡赣西/萍乡电视台赣西频道/萍乡电视台赣西/pxtv2/萍乡赣西台
梅县综合频道	gdmxtv1	梅县综合频道/梅县综合/梅县电视台综合频道/梅县电视台综合
梅州客家公共频道	gdmztv2	梅州客家公共频道/梅州客家公共/梅州电视台客家公共频道/梅州电视台客家公共/mztv2/梅州客家公共台
常德图文频道	hncdtv4	常德图文频道/常德图文/常德电视台图文频道/常德电视台图文/常德图文台
济宁中区电视剧	sdjnzq1	济宁中区电视剧/济宁中区电视剧频道/济宁中区电视剧台
菏泽综艺频道	hztv3	菏泽综艺频道/菏泽综艺/菏泽电视台综艺频道/菏泽电视台综艺/菏泽电视台三套/菏泽电视台三/菏泽三套/菏泽三/菏泽影视频道/菏泽影视/菏泽三台/菏泽综艺台
十堰教育频道	hbsytv6	十堰教育频道/十堰教育/十堰电视台教育频道/十堰电视台教育
安阳科教频道	aytv3	安阳科教频道/安阳科教/安阳电视台科教频道/安阳电视台科教/安阳科学教育频道/安阳科学教育/安阳三套/安阳三/安阳科学教育台/安阳三台
许昌综合频道	hnxctv1	许昌综合频道/许昌综合/许昌电视台新闻综合频道/许昌电视台新闻综合/许昌一套/许昌一/许昌新闻综合频道/许昌新闻综合/许昌一台/许昌新闻综合台
NEWTV农业致富	nyzhifu	newtv农业致富
多彩云韩剧	gzhjjc	多彩云韩剧
商丘文体科教频道	sqtvca3	商丘文体科教频道/商丘文体科教/商丘电视台文体科教频道/商丘电视台文体科教/商丘文体科教台
东海影视频道	dhys	东海影视频道/东海影视/东海电视台影视频道/东海电视台影视/晶城影院频道/晶城影院
亳州新闻频道	haozhoutv1	亳州新闻频道/亳州新闻/亳州电视台新闻综合频道/亳州电视台新闻综合/亳州新闻综合频道/亳州新闻综合/亳州综合频道/亳州综合/亳州新闻综合台/亳州综合台
环球军事	huanqiujs	环球军事
胜利影视频道	slyttv2	胜利影视频道/胜利影视/胜利电视台影视频道/胜利电视台影视/胜利电视二套/胜利电视二/胜利2/胜利二台/胜利二
东营经济频道	dytvca3	东营经济频道/东营经济/东营电视台经济频道/东营电视台经济/东营经济台
白银公共频道	baiyintv2	白银公共频道/白银公共/白银电视台公共频道/白银电视台公共/白银公共台
河池新闻综合频道	hchtv1	河池新闻综合频道/河池新闻综合/河池电视台新闻综合频道/河池电视台新闻综合
仪征新闻频道	yizhengxw	仪征新闻频道/仪征新闻/仪征电视台新闻综合频道/仪征电视台新闻综合/仪征新闻综合频道/仪征新闻综合
安徽影视频道	ahtv3	安徽影视频道/安徽影视/安徽电视台影视频道/安徽电视台影视/ahtv影视频道/ahtv影视/安徽台3频道/安徽台3/安徽台影视频道/安徽台影视/ahtv3/安徽台影视台
安徽公共频道	ahtv5	安徽公共频道/安徽公共/安徽电视台公共频道/安徽电视台公共/ahtv公共频道/ahtv公共/安徽台5频道/安徽台5/安徽台公共频道/安徽台公共/ahtv5/安徽台公共台
合肥电视剧频道	hfdianshiju	合肥电视剧频道/合肥电视剧
合肥教育法制	hefeitv3	合肥教育法制/合肥电视台教育法制频道/合肥电视台教育法制/合肥台3频道/合肥台3/合肥台法制频道/合肥台法制/法制教育频道/法制教育/合肥电视台法制频道/合肥电视台法制/合肥电视台法制教育频道/合肥电视台法制教育/合肥台法制台/法制教育台
重庆科教频道	ccqtv4	重庆科教频道/重庆科教/重庆电视台科教频道/重庆电视台科教/重庆台科教频道/重庆台科教/重庆三套/重庆三/重庆3套/重庆3/重庆三台/重庆3台/cqtv3/cqtv科教
重庆时尚频道	ccqtv8	重庆时尚频道/重庆时尚/重庆电视台时尚频道/重庆电视台时尚/重庆台时尚频道/重庆台时尚/重庆七套/重庆七/重庆7套/重庆7/cqtv时尚/cqtv7/重庆七台
福建电视剧频道	fjtv5	福建电视剧频道/福建电视剧/福建电视台电视剧频道/福建电视台电视剧/福建tv5频道/福建tv5/福建电视电视剧频道/福建电视电视剧/福建台电视剧频道/福建台电视剧/fjtv5/福建5电视剧/福建5影视
福建少儿频道	fjtv9	福建少儿频道/福建少儿/福建电视台少儿频道/福建电视台少儿/福建台少儿频道/福建台少儿/fjtv9/福建9少儿/福建少儿台
莆田新闻综合频道	pttv1	莆田新闻综合频道/莆田新闻综合/莆田电视台新闻综合频道/莆田电视台新闻综合/福建莆田电视台/福建莆田电视/莆田1套/莆田1/莆田一台/莆田一
龙岩公共频道	fjly2	龙岩公共频道/龙岩公共/龙岩电视台公共频道/龙岩电视台公共/龙岩公共台
三明综合频道	smtv1	三明综合频道/三明综合/三明电视台综合频道/三明电视台综合/福建三明电视台/福建三明电视/三明1套/三明1/三明一台/三明一
甘肃文化影视频道	gstv6	甘肃文化影视频道/甘肃文化影视/甘肃电视台文化影视频道/甘肃电视台文化影视/甘肃台影视频道/甘肃台影视/甘肃影视台/甘肃影视/甘肃影视电视台/甘肃影视电视/甘肃文化/甘肃影视频道/甘肃文化台
天水导视	tsdaoshi	天水导视
兰州综艺体育频道	lanzhoutv2	兰州综艺体育频道/兰州综艺体育/兰州电视台综艺体育频道/兰州电视台综艺体育/兰州综艺频道/兰州综艺/兰州体育频道/兰州体育/兰州综艺体育台
U导视	udaoshi	u导视
深圳卫视	sztv1	深圳卫视/深圳卫视频道/深圳卫星电视/深圳卫星频道/深圳卫星/深圳电视台/深圳电视/深圳台/深圳/深圳tv
潮州新闻综合	czbtv1	潮州新闻综合/潮州电视台新闻综合频道/潮州电视台新闻综合/广东潮州电视台新闻综合频道/广东潮州电视台新闻综合/潮州新闻综合频道/潮州电视台综合频道/潮州电视台综合/潮州综合频道/潮州综合/czbtv1/潮州新闻综合台/潮州台新闻综合频道/潮州台新闻综合
广西都市频道	guanxi3	广西都市频道/广西都市/广西电视台都市频道/广西电视台都市/gxtv 生活频道/gxtv 生活/广西台生活频道/广西台生活/广西都市生活频道/广西都市生活/广西生活频道/广西生活/广西生活台/广西都市生活台
海南新闻频道	hainantv2	海南新闻频道/海南新闻/海南电视台新闻频道/海南电视台新闻/海南新闻台
海南青少频道	hainantv4	海南青少频道/海南青少/海南电视台青少频道/海南电视台青少/海南第四频道/海南第四/海南四套/海南四/海南四套少儿/海南四台/海南少儿/海南少儿台
海南青少文娱频道	hnwt	海南青少文娱频道/海南青少文娱/海南文体信息/海南青少文娱台
海口生活娱乐频道	haikoutv2	海口生活娱乐频道/海口生活娱乐/海口电视台生活娱乐频道/海口电视台生活娱乐/海口电视台二套生活娱乐频道/海口电视台二套生活娱乐/海口二套/海口二/海口电视台2/海口二台/海口生活娱乐台/海口2套/海口2
邢台新闻综合频道	xttv1	邢台新闻综合频道/邢台新闻综合/邢台电视台新闻综合频道/邢台电视台新闻综合/邢台电视台1/邢台台新闻综合频道/邢台台新闻综合/邢台电视台一套新闻综合频道/邢台电视台一套新闻综合/xttv1/邢台一套/邢台一/邢台1套/邢台1/邢台1台/邢台一台/邢台综合
大庆综合频道	daqingtv1	大庆综合频道/大庆综合/大庆电视台新闻综合频道/大庆电视台新闻综合/大庆台新闻综合频道/大庆台新闻综合/大庆新闻频道/大庆新闻/大庆电视台综合频道/大庆电视台综合/大庆新闻综合
大庆百湖频道	daqingtv2	大庆百湖频道/大庆百湖/大庆电视台百湖频道/大庆电视台百湖/大庆台百湖频道/大庆台百湖/大庆tv百湖频道/大庆tv百湖/大庆台百湖台/大庆tv百湖台
油田综合	dqyt	油田综合/大庆油田有线电视
河南新闻频道	hntv6	河南新闻频道/河南新闻/河南电视台新闻频道/河南电视台新闻/河南六套/河南六/河南6套/河南6/河南台新闻频道/河南台新闻/hntv6/hntv新闻/河南电视台6/河南电视台精品博览频道/河南电视台精品博览/hntv6新闻/河南六台
郑州文体频道	zhengzhoutv3	郑州文体频道/郑州文体/郑州电视台文体频道/郑州电视台文体/zztv3/zztv3文化娱乐频道/zztv3文化娱乐/郑视文化娱乐频道/郑视文化娱乐/郑州3套/郑州3/郑州电视台3套/郑州电视台3/郑州三套/郑州三/郑州文化娱乐台/郑州文化娱乐/郑州文娱频道/郑州文娱/郑州电视台文化娱乐频道/郑州电视台文化娱乐/郑州三台/郑州文化娱乐频道
南阳新闻综合	nytv1	南阳新闻综合/南阳电视台新闻综合频道/南阳电视台新闻综合/nytv1/南阳电视台1套/南阳电视台1/南阳台新闻综合频道/南阳台新闻综合/南阳综合频道/南阳综合/南阳新闻频道/南阳新闻/南阳一台/南阳一
南阳公共频道	nytv2	南阳公共频道/南阳公共/南阳电视台公共频道/南阳电视台公共/nytv2/南阳电视台2套/南阳电视台2/南阳台社会生活频道/南阳台社会生活/南阳社会频道/南阳社会/南阳生活频道/南阳生活/南阳二套/南阳二/南阳2台/南阳2/南阳二台/南阳2套/南阳电视台社会生活频道/南阳电视台社会生活/南阳社会生活频道/南阳社会生活
湖北综合频道	hubei2	湖北综合频道/湖北综合/湖北电视台综合频道/湖北电视台综合/湖北电视台黄金剧场/湖北电视台一套/湖北电视台一/湖北一套/湖北一/湖北一台
武汉文体频道	whtv5	武汉文体频道/武汉文体/武汉电视台文体频道/武汉电视台文体/武汉5台/武汉5/武汉5套/武汉电视台体育/武汉电视台五套/武汉电视台五/武汉五套/武汉五/武汉体育/whtv5/武汉五台/武汉电视台体育频道/武汉体育台/武汉文体台
武汉少儿频道	whtv7	武汉少儿频道/武汉少儿/武汉电视台少儿频道/武汉电视台少儿/武汉7台/武汉7/武汉7套/武汉电视台七套/武汉电视台七/武汉七套/武汉七/whtv7/武汉七台/武汉少儿台
武汉教育电视台	wetv	武汉教育电视台/武汉教育电视/武汉教育
黄冈新闻综合	hbhgtv1	黄冈新闻综合/黄冈电视台新闻综合频道/黄冈电视台新闻综合/黄冈电视台一套/黄冈电视台一/黄冈一套/黄冈一/黄冈新闻频道/黄冈新闻/黄冈电视台/黄冈电视/黄冈一台/黄冈新闻台
黄冈公共频道	hbhgtv2	黄冈公共频道/黄冈公共/黄冈电视台公共频道/黄冈电视台公共/黄岗电视台二套/黄岗电视台二/黄岗二套/黄岗二/黄岗二台
湖南卫视欧洲	hunantv9	湖南卫视欧洲频道/湖南卫视欧洲
长株潭一套	czt1	长株潭一套/长株潭一/长株潭频道一
南京教科频道	njtv3	南京教科频道/南京教科/南京电视台教育科技频道/南京电视台教育科技/江苏南京教科频道/江苏南京教科/南京电视台教科频道/南京电视台教科/南京台教科频道/南京台教科/南京教育科技频道/南京教育科技/南京科教频道/南京科教/南京科教台
常熟影视娱乐频道	changshu3	常熟影视娱乐频道/常熟影视娱乐/常熟电视台影视娱乐频道/常熟电视台影视娱乐
无锡都市资讯频道	wuxi7	无锡都市资讯频道/无锡都市资讯/无锡电视台都市资讯/无锡台都市资讯/无锡都市频道/无锡都市/无锡电视都市资讯频道/无锡电视都市资讯/无锡资讯/无锡资讯频道/无锡都市台
辽宁青少频道	lntv5	辽宁青少频道/辽宁青少/辽宁电视台教育青少频道/辽宁电视台教育青少/辽宁青少电视台/辽宁青少电视/辽宁青少台/辽宁电视台青少频道/辽宁电视台青少/辽宁教育频道/辽宁教育
大连生活频道	dalian2	大连生活频道/大连生活/大连电视台生活频道/大连电视台生活/dltv2/dltv生活频道/dltv生活/大连电视台2/大连生活台/大连2套/大连2/大连二套/大连二/大连2台/大连二台
晋城公共娱乐频道	jctv2	晋城公共娱乐频道/晋城公共娱乐/晋城电视台公共频道/晋城电视台公共/山西晋城电视台公共娱乐频道/山西晋城电视台公共娱乐/jctv2/晋城公共频道/晋城公共/晋城电视台公共娱乐频道/晋城电视台公共娱乐/晋城公共台
山东综艺频道	sdtv8	山东综艺频道/山东综艺/山东电视台综艺频道/山东电视台综艺/山东电视综艺频道/山东电视综艺/sdtv综艺/山东综艺台
青岛生活服务频道	sdqd2	青岛生活服务频道/青岛生活服务/青岛电视台生活服务频道/青岛电视台生活服务/qtv2生活服务频道/qtv2生活服务/青岛2台/青岛2/青岛二台/青岛二/青岛2套/青岛二套/qtv2/青岛台生活服务频道/青岛台生活服务/青岛生活服务台青岛二台/青岛生活服务台青岛二
济南少儿频道	jntv7	济南少儿频道/济南少儿/济南电视台少儿频道/济南电视台少儿/jntv7少儿频道/jntv7少儿/jntv7/济南少儿电视台/济南少儿电视
淄博新闻综合	zbrt1	淄博新闻综合/淄博电视台新闻综合频道/淄博电视台新闻综合/淄博新闻综合频道/淄博新闻频道/淄博新闻/淄博新闻台
淄博公共频道	zbrt2	淄博公共频道/淄博公共/淄博电视台公共频道/淄博电视台公共/淄博影视频道/淄博影视/淄博电视台二台/淄博电视台二/淄博二套/淄博二/淄博台影视频道/淄博台影视/淄博影视台/淄博二台
淄博都市频道	zbrt4	淄博都市频道/淄博都市/淄博电视台都市频道/淄博电视台都市/zbrt4/淄博都市台
日照快乐频道	rizhao3	日照快乐频道/日照快乐/日照电视台公共频道/日照电视台公共/日照公共频道/日照公共/日照公共台
第一财经	shhai2	第一财经/上海电视台第一财经频道/上海电视台第一财经/上海第一财经电视台/上海第一财经电视/上海台第一财经频道/上海台第一财经/上视电视台第一财经频道/上视电视台第一财经/第一财经频道/上海第一财经/上视第一财经频道/上视第一财经/第1财经/第一财经cbn/iptv股评汇/第1財經電視
劲爆体育	sitv4	劲爆体育/新视觉体育高清频道/新视觉体育高清/新视觉高清台/新视觉高清/新视觉体育/新视觉高清体育/新视觉hd体育/新视觉标清体育
魅力音乐	sitv5	魅力音乐/上海新视觉娱乐高清/sitv新视觉娱乐高清频道/sitv新视觉娱乐高清/上海新视觉娱乐高清频道/新视觉娱乐/新视觉高清娱乐/新视觉hd娱乐/魅力音乐hd
陕西一套	shxitv2	陕西一套/陕西一/陕西电视台新闻综合频道/陕西电视台新闻综合/陕视新闻综合频道/陕视新闻综合/陕西电视台1套/陕西电视台1/陕西电视台一套/陕西电视台一/陕西台新闻综合频道/陕西台新闻综合/陕西新闻综合频道/陕西新闻综合/陕西一台/陕西1台/陕西1/陕西1套/陕西电视台新闻频道/陕西电视台新闻/sxtvs2/陕西新闻
陕西二套	shxitv3	陕西二套/陕西二/陕西电视台都市青春频道/陕西电视台都市青春/陕视都市青春频道/陕视都市青春/陕西电视台2套/陕西电视台2/陕西都市青春频道/陕西都市青春/陕西台都市青春频道/陕西台都市青春/陕西2台/陕西2/陕西2套/陕西二台
四川公共频道	sctv9	四川公共频道/四川公共/四川电视台公共频道/四川电视台公共/sctv9/sctv9公共频道/sctv9公共/四川电视台9套/四川电视台9/四川公共频道sctv9/sctv公共/四川9/四川九台/四川九
成都少儿频道	cdtv_6	成都少儿频道/成都少儿/成都电视台少儿频道/成都电视台少儿/cdtv6/cdtv6少儿频道/cdtv6少儿/cdtv6成都少儿频道/cdtv6成都少儿/成都六台/成都六/成都少儿台
XJTV3	xjtv3	xjtv3/新疆电视台哈萨克语新闻综合频道/新疆电视台哈萨克语新闻综合/新疆电视台第三频道哈萨克语新闻综合频道/新疆电视台第三频道哈萨克语新闻综合/新疆电视台三频道/新疆电视台三/新疆电视台三套哈萨克语新闻综合频道/新疆电视台三套哈萨克语新闻综合/新疆哈萨克语新闻综合频道/新疆哈萨克语新闻综合/新疆台3频道/新疆台3/新疆哈萨克语频道/新疆哈萨克语/新疆电视台哈萨克语频道/新疆电视台哈萨克语/哈萨克语新闻频道/哈萨克语新闻/新疆哈语新闻综合/新疆三台/新疆三
杭州少儿频道	htv5	杭州少儿频道/杭州少儿/杭州电视台少儿频道/杭州电视台少儿/杭州台少儿频道/杭州台少儿/杭州五台/杭州五/htv5/杭州五套/杭州5套/杭州5/杭州体育频道/杭州体育/杭州台少儿台
西藏卫视藏语	xizangtv1	西藏卫视(藏语)/西藏电视台藏语卫视/西藏台藏语综合频道/西藏台藏语综合/西藏卫视频道/西藏卫视/西藏卫视台/西藏卫星电视/西藏卫星频道/西藏卫星/西藏一套/西藏一/西藏1套/西藏1/西藏一台/西藏1台/西藏藏语/西藏卫视藏语/西藏藏语频道
临汾一套	linfentv1	临汾一套/临汾一/临汾电视台一套/临汾电视台一/临汾1套/临汾1/临汾台一套/临汾台一/临汾新闻综合频道/临汾新闻综合/临汾一台/临汾1台
临汾二套	linfentv2	临汾二套/临汾二/临汾电视台二套/临汾电视台二/临汾2套/临汾2/临汾台二套/临汾台二/临汾综艺生活频道/临汾综艺生活/临汾二台/临汾2台
牡丹江金融频道	moudanjian4	牡丹江金融频道/牡丹江金融/牡丹江电视台金融频道/牡丹江电视台金融
南宁都市生活频道	nanningtv3	南宁都市生活频道/南宁都市生活/南宁电视台都市生活频道/南宁电视台都市生活/南宁台都市生活频道/南宁台都市生活/南宁都市频道/南宁都市/南宁生活频道/南宁生活/南宁都市生活台/南宁都市台/南宁生活台
义乌商贸频道	zjyiwu2	义乌商贸频道/义乌商贸/义乌电视台商贸频道/义乌电视台商贸/义乌台商贸频道/义乌台商贸
义乌公共文艺	zjyiwu3	义乌公共文艺/义乌电视台公共文艺频道/义乌电视台公共文艺/义乌台电视剧频道/义乌台电视剧/义乌电视台电视剧频道/义乌电视台电视剧
延边TV2	ybtv2	延边tv2/延边电视台经济生活频道/延边电视台经济生活/延边经济文化频道/延边经济文化/延边经济文化台
信阳公共频道	xinyang3	信阳公共频道/信阳公共/信阳电视台公共频道/信阳电视台公共/信阳公共台
石家庄三套	shijiazhuang3	石家庄三套/石家庄三/石家庄电视台生活频道/石家庄电视台生活/石家庄电视台3/石家庄电视台3频道/石家庄电视台3套/石家庄电视台三套/石家庄电视台三/石家庄3套/石家庄3/石家庄3台/石家庄三台/石家庄生活频道/石家庄生活/石家庄生活台
三门峡公共频道	sanmengxia2	三门峡公共频道/三门峡公共/三门峡电视台公共频道/三门峡电视台公共/三门峡2台/三门峡2/三门峡2套/三门峡二台/三门峡二/三门峡二套/三门峡公共台
秦皇岛影视台	qinhuangdao3	秦皇岛影视台/秦皇岛影视/秦皇岛电视台影视频道/秦皇岛电视台影视/秦皇岛3台/秦皇岛3/秦皇岛3套/秦皇岛三套/秦皇岛三/秦皇岛影视频道/qhd3/秦皇岛电视台3/秦皇岛三台
环球旅游	bamc6	环球旅游/数字电视环球旅游频道/数字电视环球旅游/环球旅游频道
时代风尚	bamc19	时代风尚
中国气象频道	china_weather_tv	中国气象频道/中国气象/cctv气象频道/cctv气象/数字电视中国气象频道/数字电视中国气象/气象频道/气象
孝感公共频道	xiaogan1	孝感公共频道/孝感公共/孝感电视台公共频道/孝感电视台公共/孝感公共台/孝感生活频道/孝感生活
孝感影视频道	xiaogan2	孝感影视频道/孝感影视/孝感电视台影视频道/孝感电视台影视/孝感影视台/孝感电影频道/孝感电影
江西教育	jxetv	江西教育/江西教育频道
高清探索频道地区	szthm_discovery2	高清探索频道地区/探索频道地区高清
漫游世界	hsmysj	漫游世界/华数漫游世界/漫游天下频道/漫游天下
沈阳导视	syds	沈阳导视
CINEMAX	cinemax_cn	cinemax/cinemax频道/hbo cinemax/cinemax电影/cinemax电影台/cinmax
CNN	cnn1	CNN/CNN国际新闻/CNN Asia/CNN schedule/CNN国际新闻网络/CNN国际台/CNN国际新闻台/CNN International/CNN Int'l/CNN Int’l/CNN 国际新闻网络/CNN新闻台/CNN US/CNNi 國際新聞網絡/CNN新闻/CNN INT
STAR MOVIES	star_movies_cn	star movies/卫视国际电影频道/卫视国际电影/星空国际电影频道/星空国际电影/卫视国际电影台/星空影院/卫视西片/卫视西片台/star movie
NHK WORLD TV	nhk_world_tv	nhk world tv/nhk world/nhkw
运城新闻综合频道	yctv1	运城新闻综合频道/运城新闻综合/运城电视台一套/运城电视台一/运城1套/运城1/运城电视台1套/运城电视台1/运城一套/运城一/运城一台
吴江电视剧频道	wjtv3	吴江电视剧频道/吴江电视剧/吴江电视台电视剧频道/吴江电视台电视剧
徐州新闻综合	xztv1	徐州新闻综合/徐州电视台新闻综合频道/徐州电视台新闻综合/徐州·1
徐州公共频道	xztv4	徐州公共频道/徐州公共/徐州电视台公共频道/徐州电视台公共/徐州·4
健康卫视	jkwshk	健康卫视
三沙卫视	sanshatv	三沙卫视
吉林教育	jletv	吉林教育/吉林教育电视台/吉林教育电视
吉林市公共频道	jlctv3	吉林市公共频道/吉林市公共/吉林市电视台公共民生频道/吉林市电视台公共民生/吉林市公共台
乌兰察布新闻综合	wlcbtv1	乌兰察布新闻综合/乌兰察布电视台新闻综合频道/乌兰察布电视台新闻综合/乌兰察布1/乌兰察布一台/乌兰察布一
鄂尔多斯汉语综合	eedstv1	鄂尔多斯汉语综合/鄂尔多斯广播电视台汉语综合频道 /鄂尔多斯广播电视台汉语综合频道/鄂尔多斯1/鄂尔多斯新闻综合频道/鄂尔多斯新闻综合/鄂尔多斯一台/鄂尔多斯一
九江一套	jxjjtv1	九江一套/九江一/九江电视台新闻综合频道/九江电视台新闻综合/jjtv1
九江二套	jxjjtv2	九江二套/九江二/九江电视台经济民生频道/九江电视台经济民生/jjtv2
天长影视频道	ahtctv2	天长影视频道/天长影视/天长电视台影视频道/天长电视台影视/天长影视台
盐城一套	yanchengtv1	盐城一套/盐城一/盐城电视台一套/盐城电视台一/盐城电视台新闻综合频道/盐城电视台新闻综合/盐城新闻综合/盐城新闻综合台
盐城二套	yanchengtv2	盐城二套/盐城二/盐城电视台二套/盐城电视台二/盐城电视台法制生活频道/盐城电视台法制生活/盐城法制生活/盐城法制生活台
乌鲁木齐妇女儿童	utv6	乌鲁木齐妇女儿童/乌鲁木齐电视台妇女儿童频道/乌鲁木齐电视台妇女儿童/乌鲁木齐台6/utv6/乌鲁木齐台六台/乌鲁木齐台六
昌吉综合频道	cjtv1	昌吉综合频道/昌吉综合/昌吉电视台综合频道/昌吉电视台综合
北仑生活娱乐频道	blshyl	北仑生活娱乐频道/北仑生活娱乐/北仑生活娱乐台
邯郸民生频道	hdtv_3	邯郸民生频道/邯郸民生/邯郸电视台民生频道/邯郸电视台民生/邯郸电视台民生都市频道/邯郸电视台民生都市/邯郸民生台
澳门莲花卫视	lotusbtv	澳门莲花卫视/莲花卫视/澳门莲花台/澳门莲花/澳门莲花电视台/澳门莲花电视
承德电视台2	chengdetv2	承德电视台2/承德电视台公共生活频道/承德电视台公共生活/承德电视台都市频道/承德电视台都市/承德都市频道/承德都市/承德公共生活
遵义都市频道	gzzytv2	遵义都市频道/遵义都市/遵义电视台都市频道/遵义电视台都市/遵义都市台
好剧赏析频道	gzzytv4	好剧赏析频道/好剧赏析/遵义好剧赏析频道/遵义好剧赏析/遵义影视购物台/遵义影视购物
蚌埠公共频道	ahbbtv3	蚌埠公共频道/蚌埠公共/蚌埠电视台公共频道/蚌埠电视台公共
马鞍山新闻频道	maanshantv1	马鞍山新闻频道/马鞍山新闻/马鞍山电视台新闻综合频道/马鞍山电视台新闻综合
芜湖教育频道	wuhutv4	芜湖教育频道/芜湖教育/芜湖电视台教育频道/芜湖电视台教育
金昌综合频道	gsjctv1	金昌综合频道/金昌综合/金昌电视台综合频道/金昌电视台综合/金昌综合台
攀枝花新闻综合	scpzhtv1	攀枝花新闻综合/攀枝花电视台新闻综合频道/攀枝花电视台新闻综合
萍乡公共频道	pxitv3	萍乡公共频道/萍乡公共/萍乡电视台公共频道/萍乡电视台公共
赣州三套	jxgztv3	赣州三套/赣州三/赣州电视台科教农业频道/赣州电视台科教农业/赣州三台
上饶一套	jxsrtv1	上饶一套/上饶一/上饶电视台新闻综合频道/上饶电视台新闻综合/srtv1/上饶一台
上饶二套	jxsrtv2	上饶二套/上饶二/上饶电视台公共频道/上饶电视台公共/srtv2/上饶二台
株洲法制频道	hnzztv3	株洲法制频道/株洲法制/株洲电视台法制频道/株洲电视台法制/株洲法制台
北海经济科教频道	bhtv2	北海经济科教频道/北海经济科教/北海电视台经济科教频道/北海电视台经济科教
菏泽新闻综合频道	hztv1	菏泽新闻综合频道/菏泽新闻综合/菏泽电视台综合频道/菏泽电视台综合/菏泽电视台一套/菏泽电视台一/菏泽一套/菏泽一/菏泽一台/菏泽新闻台/菏泽新闻
潮安综合频道	chaantv1	潮安综合频道/潮安综合/潮安电视台综合频道/潮安电视台综合
益阳乡村频道	yyrtvxc	益阳乡村频道/益阳乡村/益阳电视台乡村频道/益阳电视台乡村/益阳乡村台
TCB潮视	ecstv	tcb潮视/潮商卫视/潮视卫视
NEWTV惊悚悬疑	jsxuanyi	newtv惊悚悬疑
魅力青春	mlqingchun	魅力青春
丽水文化休闲频道	lswhxx	丽水文化休闲频道/丽水文化休闲/丽水电视台文化休闲频道/丽水电视台文化休闲
商丘教育频道	sqjytv	商丘教育频道/商丘教育/商丘教育台
衢州新闻综合	qztv_1	衢州新闻综合/衢州电视台一套/衢州电视台一/qztv1/衢州一台/衢州一/衢州新闻综合频道
钦州公共频道	qztvca2	钦州公共频道/钦州公共/钦州电视台公共频道/钦州电视台公共/钦州公共影视
热力音乐	reliyy	热力音乐
漯河教育台	lhjytv4	漯河教育台/漯河教育
长治新闻综合频道	cztvca1	长治新闻综合频道/长治新闻综合/长治电视台新闻综合频道/长治电视台新闻综合/长治tv1/长治新闻台/长治新闻/长治一台/长治一
绍兴县新闻综合	shaoxtv2	绍兴县新闻综合/绍兴县新闻综合频道/绍兴县新闻综合台
遂宁综合频道	uiningtv1	遂宁综合频道/遂宁综合/遂宁电视台综合频道/遂宁电视台综合/遂宁新闻频道/遂宁新闻/遂宁新闻台/遂宁综合台
雅安新闻综合频道	yaantv1	雅安新闻综合频道/雅安新闻综合/雅安电视台新闻综合频道/雅安电视台新闻综合/雅安综合/雅安综合台
内江城市公共频道	neijtv1	内江城市公共频道/内江城市公共/内江电视台城市公共频道/内江电视台城市公共/内江公共频道/内江公共/内江公共台
辽河一套	shlhtv1	辽河一套/辽河一/辽河电视台一套/辽河电视台一/辽河一台
辽河二套	sylhtv2	辽河二套/辽河二/辽河电视台二套/辽河电视台二/辽河二台
宿州四套	suzhtv4	宿州四套/宿州四/宿州电视台四套/宿州电视台四/宿州四台
六安都市生活频道	liuantv1	六安都市生活频道/六安都市生活/六安电视台都市生活频道/六安电视台都市生活/六安都市生活台
TV5	tv5	tv5/tv 5
溧水影视娱乐	lishuiys	溧水影视娱乐/溧水电视台影视娱乐频道/溧水电视台影视娱乐
睛彩重庆	jccq	睛彩重庆
渭南华山频道	weinanhs	渭南华山频道/渭南华山/渭南2/渭南二台/渭南二/渭南华山台
合肥都市频道	hfdushi	合肥都市频道/合肥都市
合肥财经频道	hefeitv4	合肥财经频道/合肥财经/合肥电视台财经频道/合肥电视台财经/合肥台4频道/合肥台4/合肥台财经频道/合肥台财经/合肥财经台
BTV卡酷少儿	btv10	btv卡酷少儿/北京电视台卡通频道/北京电视台卡通/btv10/btv10台/btv10套/btv卡通/btv卡通频道/btv卡通台/北京电视台十套/北京电视台十/北京十台/北京十/北京十套/北京台卡通频道/北京台卡通/btv10动画/卡酷动画/卡酷卫视/卡酷少儿/卡酷卡通/北京卡酷动画/北京卡酷/北京卡通/btv卡酷/北京少儿
福建新闻频道	fjtv4	福建新闻频道/福建新闻/福建电视台新闻频道/福建电视台新闻/福建tv4频道/福建tv4/福建电视新闻频道/福建电视新闻/福建台新闻频道/福建台新闻/fjtv4/福建4新闻/福建台新闻频道福建4新闻
厦门生活频道	xmtv3	厦门生活频道/厦门生活/厦门电视台生活频道/厦门电视台生活/厦门电视生活频道/厦门电视生活/厦门三套/厦门三/厦门3套/厦门3/xmtv3/厦门三台
厦门卫视欧洲	xmtv8	厦门卫视欧洲
漳州新闻综合	zztv1	漳州新闻综合/漳州新闻综合电视台频道/漳州新闻综合电视台/漳州 1套/漳州 1/漳州电视台一套/漳州电视台一/漳州市电视台一套/漳州市电视台一/漳州一套/漳州一/漳州一套黄金剧场/漳州1套/漳州1/漳州一台/漳州1台/zztv1/漳州黄金剧场
漳州公共频道	zztv2	漳州公共频道/漳州公共/漳州 2套/漳州 2/漳州电视台二套/漳州电视台二/漳州二套/漳州二/漳州二套魅力剧场/漳州市电视台二套/漳州市电视台二/漳州2套/漳州2/漳州二台/漳州2台/zztv2/漳州文化生活/漳州魅力剧场频道/漳州魅力剧场
天水公共频道	tstv2	天水公共频道/天水公共/天水电视台公共频道/天水电视台公共/天水公共电视台/天水公共电视/天水公共台
深视财经生活频道	sztv4	深视财经生活频道/深视财经生活/深圳电视台财经生活频道/深圳电视台财经生活/深视三套/深视三/深圳3套/深圳3/深圳3套财经生活频道/深圳3套财经生活/深圳财经生活频道/深圳财经生活/深圳三台/深圳三/深圳财经频道/深圳财经/深圳三套/深圳3台/深视财经频道/深视财经
深视体育健康频道	sztv6	深视体育健康频道/深视体育健康/深圳电视台体育健康频道/深圳电视台体育健康/深视5套体育健康频道/深视5套体育健康/深视五套/深视五/深圳5套/深圳5/深圳五台/深圳五/深视体育/深圳体育频道/深圳体育/深圳体育健康频道/深圳体育健康/深圳五套/深圳5台
广州影视频道	gztv4	广州影视频道/广州影视/广州电视台影视频道/广州电视台影视/广视影视频道/广视影视/广州影视台/广州电视剧/gztv4
佛山南海频道	gdfs4	佛山南海频道/佛山南海/佛山电视台南海频道/佛山电视台南海/佛山台南海频道/佛山台南海/广东佛山电视台南海频道/广东佛山电视台南海/gdfs4/南海频道/南海
中山导视频道	gdzs4	中山导视频道/中山导视/中山电视台导视频道/中山电视台导视
茂名公共频道	mmtv1	茂名公共频道/茂名公共/茂名电视台公共频道/茂名电视台公共/广东茂名电视台/广东茂名电视/茂名市电视台/茂名市电视/茂名电视台/茂名电视
TVS3综艺频道	nanfang3	tvs3综艺频道/tvs3综艺
TVS5少儿频道	nanfang5	tvs5少儿频道/tvs5少儿
贵州娱乐频道	guizoutv4	贵州娱乐频道/贵州娱乐/贵州电视台四频道/贵州电视台四/贵州大众生活频道/贵州大众生活/贵州电视台影视文艺频道/贵州电视台影视文艺/贵州台大众生活频道/贵州台大众生活/贵州影视文艺频道/贵州影视文艺/贵州4频道/贵州4/贵州四台/贵州四
贵州法制频道	guizoutv5	贵州法制频道/贵州法制/贵州电视台五频道/贵州电视台五/贵州5频道/贵州5/贵州第5频道/贵州第5/贵州台5频道/贵州台5/贵州五频道/贵州五/贵州第五频道/贵州第五/贵州五台
贵视法制频道	gytv3	贵视法制频道/贵视法制/贵阳电视台法制频道/贵阳电视台法制/贵视台法制频道/贵视台法制/贵阳3/贵阳三台/贵阳三
旅游卫视	tctc1	旅游卫视/旅游卫视频道/旅游卫星电视/旅游卫星频道/旅游卫星/海南卫视/海南旅游卫视/旅游台/旅游电视台/旅游tv/旅游电视
河北交通频道	hbjt	河北交通频道/河北交通
邢台公共娱乐频道	xttv3	邢台公共娱乐频道/邢台公共娱乐/邢台电视台公共娱乐频道/邢台电视台公共娱乐/邢台电视台3/邢台台公共频道/邢台台公共/xttv3/邢台三套/邢台三/邢台3套/邢台3/邢台娱乐频道/邢台娱乐/邢台公共
衡水公共频道	hsbtv2	衡水公共频道/衡水公共/衡水电视台公共频道/衡水电视台公共/衡水台公共频道/衡水台公共
河南民生频道	hntv3	河南民生频道/河南民生/河南电视台民生频道/河南电视台民生/河南三套/河南三/河南3套/河南3/河南民生台/hntv3/hntv3民生/河南电视台3/河南三台
河南国际频道	hngj	河南国际频道/河南国际/hntv11国际
郑州教育	zetv	郑州教育/郑州教育电视台/郑州教育电视
郑州都市生活频道	zhengzhoutv4	郑州都市生活频道/郑州都市生活/郑州电视台都市生活频道/郑州电视台都市生活/zztv4/zztv4导购频道/zztv4导购/郑视导购频道/郑视导购/郑州4套/郑州4/郑州电视台4套/郑州电视台4/郑州四套/郑州四/郑州电视台导购频道/郑州电视台导购/郑州时尚频道/郑州时尚/郑州四台/郑州生活台/郑州生活
洛阳综合频道	lytv1	洛阳综合频道/洛阳综合/洛阳电视台新闻综合频道/洛阳电视台新闻综合/lytv1/洛阳一台/洛阳一/洛阳1台/洛阳1/洛阳电视台1套/洛阳电视台1/洛阳台新闻综合频道/洛阳台新闻综合/洛阳新闻频道/洛阳新闻/洛阳台新闻综合台/洛阳新闻台
洛阳科教频道	lytv3	洛阳科教频道/洛阳科教/洛阳电视台科教法制频道/洛阳电视台科教法制/洛阳二台/洛阳二/洛阳科教台
洛阳文娱频道	lytv4	洛阳文娱频道/洛阳文娱/洛阳电视台影视文娱频道/洛阳电视台影视文娱/lytv4/洛阳电视台4套/洛阳电视台4/洛阳4台/洛阳4/洛阳台旅游文体频道/洛阳台旅游文体/洛阳影视频道/洛阳影视/洛阳4套/洛阳影视文娱频道/洛阳影视文娱/洛阳四台/洛阳四/洛阳台旅游文体台/洛阳影视台
开封新闻综合频道	kftv1	开封新闻综合频道/开封新闻综合/开封电视台新闻综合频道/开封电视台新闻综合/开封电视台1套/开封电视台1/开封台新闻综合频道/开封台新闻综合/开封新闻频道/开封新闻/开封综合频道/开封综合/河南开封新闻综合频道/河南开封新闻综合/kftv1/开封1台/开封1
新乡教育频道	xxjy	新乡教育频道/新乡教育/新乡电视台教育频道/新乡电视台教育/新乡教育台
湖北教育频道	hubei4	湖北教育频道/湖北教育/湖北电视台教育频道/湖北电视台教育/湖北教育台/湖北省电视台教育频道/湖北省电视台教育
武汉科技生活频道	whtv3	武汉科技生活频道/武汉科技生活/武汉电视台科技生活频道/武汉电视台科技生活/武汉3台/武汉3/武汉3套/武汉电视台科教生活/武汉电视台三套/武汉电视台三/武汉三台/武汉三/武汉三套/武汉科教/武汉科教生活/whtv3/武汉生活频道/武汉生活/武汉科教生活台/武汉科教台
荆州垄上台	jztv2	荆州垄上台/荆州垄上/荆州电视台垄上频道/荆州电视台垄上/荆州垄上频道/荆州电视垄上频道/荆州电视垄上/湖北垄上/垄上电视台/垄上电视
湖南教育台	hnedutv1	湖南教育台/湖南教育/湖南教育电视台/湖南教育电视/湖南edutv教育台/湖南edutv教育/湖南教育频道/湖南edutv
长沙女性频道	changshawumon1	长沙女性频道/长沙女性/长沙电视台女性频道/长沙电视台女性/长沙台女性频道/长沙台女性/长沙womantv频道/长沙womantv/长沙女性台
江苏学习频道	jetvzk	江苏学习频道/江苏学习/学习频道/学习/江苏招考频道/江苏招考/招考频道/招考
常州生活频道	changzhou3	常州生活频道/常州生活/常州电视台生活频道/常州电视台生活/常州台影视频道/常州台影视/常州影视台/常州影视
无锡经济频道	wuxi4	无锡经济频道/无锡经济/无锡电视台经济频道/无锡电视台经济/无锡台经济频道/无锡台经济/无锡经济台
名师讲坛	msjt	名师讲坛
江西影视娱乐频道	jxtv4	江西影视娱乐频道/江西影视娱乐/江西电视台影视娱乐频道/江西电视台影视娱乐/jxtv影视频道/jxtv影视/江西4套/江西4/江西4台/江西电视台4套/江西电视台4/江西四套/江西四/江西卫视4套/江西卫视4/jxtv4/江西电视台影视频道/江西电视台影视/江西影视频道/江西影视/台江西影视频道/台江西影视
吉视都市频道	jilin2	吉视都市频道/吉视都市/吉林电视台都市频道/吉林电视台都市/吉林都市电视台/吉林都市电视/吉林都市频道/吉林都市/吉林二套/吉林二/吉林2套/吉林2/吉林2台/吉林二台/吉林都市台
吉视影视频道	jilin4	吉视影视频道/吉视影视/吉林电视台影视频道/吉林电视台影视/吉林影视电视台/吉林影视电视/吉林影视频道/吉林影视/吉林影视台
辽宁影视剧频道	lntv3	辽宁影视剧频道/辽宁影视剧/辽宁电视台影视剧频道/辽宁电视台影视剧/辽宁3台/辽宁3/辽宁影视电视台/辽宁影视电视/辽宁影视台/辽宁影视/辽宁娱乐频道/辽宁娱乐/辽宁娱乐台/辽宁影视娱乐频道/辽宁影视娱乐
辽宁生活频道	lntv6	辽宁生活频道/辽宁生活/辽宁电视台生活频道/辽宁电视台生活
宁夏家庭影院	nxtv6	宁夏家庭影院/宁夏电视台家庭影院
山西经济资讯	sxtv2	山西经济资讯/山西电视台经济资讯频道/山西电视台经济资讯/山西台经济资讯频道/山西台经济资讯/山西二套/山西二/山西新闻综合/山西新闻综合频道/山西经济频道/山西经济/sxtv2/山西经济资讯频道
晋城新闻频道	jctv1	晋城新闻频道/晋城新闻/晋城电视台新闻综合频道/晋城电视台新闻综合/晋城电视台新闻频道/晋城电视台新闻/山西晋城电视台新闻频道/山西晋城电视台新闻/山西晋城综合频道/山西晋城综合/jctv1/晋城新闻综合
环宇电影	jddy	环宇电影/环宇电影频道/悬疑电影频道/悬疑电影/映画加频道/映画加/经典电影1频道/经典电影1
青岛影视频道	sdqd3	青岛影视频道/青岛影视/青岛电视台影视频道/青岛电视台影视/qtv3影视频道/qtv3影视/qtv3影视娱乐频道/qtv3影视娱乐/青岛三套/青岛三/青岛3套/青岛3/青岛三台/青岛3台/qtv3/青岛台影视频道/青岛台影视/青岛影视台
淄博生活法治频道	zbrt3	淄博生活法治频道/淄博生活法治/淄博电视台生活法治频道/淄博电视台生活法治/淄博生活频道/淄博生活/淄博电视台生活频道/淄博电视台生活/淄博生活台
潍坊公共频道	sdwf2	潍坊公共频道/潍坊公共/潍坊电视台公共频道/潍坊电视台公共/sdwf2影视频道/sdwf2影视/潍坊影视频道/潍坊影视/潍坊2套/潍坊2/潍坊二套/潍坊二/潍坊二台
泰安公共	tatv2	泰安公共/泰安电视台公共频道/泰安电视台公共/泰安电视台二频道/泰安电视台二/tatv2/泰安2套/泰安2/泰安台二套/泰安台二/泰安生活频道/泰安生活/泰安二套/泰安二/泰安公共台
五星体育频道	shhai5	五星体育频道/五星体育/上海电视台五星体育频道/上海电视台五星体育/上海台体育频道/上海台体育/上海体育电视台/上海体育电视/上海体育台/上海体育/上海五星体育/上视电视台体育频道/上视电视台体育/上视体育/五星体育台/五星足球/上海体育频道/上视五星体育频道/上视五星体育
上视纪实频道	shhai6	上视纪实频道/上视纪实/上海电视台纪实频道/上海电视台纪实/上海纪实电视台/上海纪实电视/上海台纪实频道/上海台纪实/上海台纪实频道收视指南/上视电视台纪实频道/上视电视台纪实/上海纪实频道/上海纪实
DOX 4K	dox_c_drama	dox 4k/4k频道/4k
康巴卫视	kamba_tv	康巴卫视/康巴藏语卫视/sctv康巴/康巴藏语频道/康巴藏语
天津搏击频道	boji	天津搏击频道/天津搏击/天津高清搏击频道/天津高清搏击/搏击高清/搏击体育/天津搏击高清/搏击体育频道/高清搏击频道/高清搏击/搏击频道hd
XJTV4	xjtv4	xjtv4/新疆电视台汉语综艺频道/新疆电视台汉语综艺/新疆电视台第四频道汉语综艺频道/新疆电视台第四频道汉语综艺/新疆电视台四频道/新疆电视台四/新疆电视台四套汉语综艺频道/新疆电视台四套汉语综艺/新疆汉语综艺频道/新疆汉语综艺/新疆台4频道/新疆台4/新疆4套/新疆4/新疆四套/新疆四/新疆四台/新疆4台/新疆综艺频道/新疆综艺
云南少儿频道	yntv8	云南少儿频道/云南少儿/云南电视台少儿频道/云南电视台少儿/yntv8/yntv8云南少儿频道/yntv8云南少儿/yntv少儿/云南少儿电视
云南国际频道	yntv9	云南国际频道/云南国际/云南电视台国际频道/云南电视台国际
昆明健康频道	kmtv3	昆明健康频道/昆明健康/昆明电视台健康频道/昆明电视台健康/kmtv3/昆明三套/昆明三/昆明3套/昆明3/昆明3台/昆明三台/昆明政法/昆明文娱频道/昆明文娱/昆明电视台政法频道/昆明电视台政法/昆明政法频道
宁波新闻综合	nbtv1	宁波新闻综合/宁波电视台新闻综合频道/宁波电视台新闻综合/宁波台新闻综合频道/宁波台新闻综合/宁波新闻综合频道/宁波一套/宁波一/宁波1套/宁波1/宁波一台/宁波1台/浙江宁波新闻综合频道/浙江宁波新闻综合/nbtv1/宁波新闻综合台
宁波影视频道	nbtv4	宁波影视频道/宁波影视/宁波电视台影视剧频道/宁波电视台影视剧/宁波台影视剧频道/宁波台影视剧/宁波影视剧频道/宁波影视剧/宁波四套/宁波四/宁波4套/宁波4/nbtv4/宁波影视台/宁波四台
温州公共民生	wztv4	温州公共民生/温州电视台公共民生频道/温州电视台公共民生/温州台影视娱乐频道/温州台影视娱乐/温州公共民生电视台/温州公共民生电视/温州电视台公共频道/温州电视台公共/温州4台/温州4/温州影视娱乐台/温州影视娱乐/温州公共民生台/温州公共台/温州公共/温州四台/温州四
湖州新起点频道	huzhoutv4	湖州新起点频道/湖州新起点/湖州电视台新起点频道/湖州电视台新起点
牡丹江教育频道	moudanjian3	牡丹江教育/牡丹江教育电视台/牡丹江教育电视/牡丹江教育频道/牡丹江电视台教育频道/牡丹江电视台教育/牡丹江台教育频道/牡丹江台教育/牡丹江教育台
牡丹江图文频道	moudanjian6	牡丹江图文频道/牡丹江图文/牡丹江电视台图文频道/牡丹江电视台图文
威海海洋频道	weihai3	威海海洋频道/威海海洋/威海电视台海洋频道/威海电视台海洋/威海三台/威海三/人居生活频道/人居生活
汕头新闻综合	srttv1	汕头新闻综合/汕头电视台新闻综合频道/汕头电视台新闻综合/汕头1台/汕头1/汕头1套/汕头新闻综合频道/汕头一套/汕头一/汕头台/汕头/汕头一台
绍兴公共频道	shaoxin2	绍兴公共频道/绍兴公共/绍兴电视台公共频道/绍兴电视台公共/浙江绍兴公共频道/浙江绍兴公共
绍兴新闻综合	shaoxin3	绍兴新闻综合/绍兴电视台新闻综合频道/绍兴电视台新闻综合/绍兴新闻频道/绍兴新闻/绍兴综合频道/绍兴综合
职业指南	bamc16	职业指南/中国数字电视职业指南频道/中国数字电视职业指南/湖北职业指南频道/湖北职业指南
财富天下	caifutianxia	财富天下/中央电视台财富天下频道/中央电视台财富天下/数字电视财富天下频道/数字电视财富天下/付费电视财富天下频道/付费电视财富天下/cctv财富天下/江苏财经频道/江苏财经
孝感孝南频道	xiaogan4	孝感孝南频道/孝感孝南/孝感电视台孝南频道/孝感电视台孝南
电子体育	esports	电子体育/电子体育频道/gtv电子体育频道/gtv电子体育/北方新媒体 电子体育
购物频道	gwpd	购物频道/购物/电视直销/风尚购物二/幸福好享购/宜和购物·东部/导购一/精品购物/乐家购物/风尚购物2/森森购物/新天地购物/电视购物/佰乐购/家禧购物/凤凰购物1/欢乐购物/好易购精品/购物1/买乐购物/沃德购物/红河买乐/购物商城/重庆购物/宁夏家有购物/南通中视购物/粤购物/珠江传媒购物/中青购物/苏州图文购物/置换聚焦/丝路精品
西宁文化先锋频道	xining_culture	西宁文化先锋频道/西宁文化先锋/西宁电视台文化先锋频道/西宁电视台文化先锋
安庆经视频道	aqjs	安庆经视频道/安庆经视/安庆电视台经济生活频道/安庆电视台经济生活/安庆经济生活频道/安庆经济生活/安庆生活频道/安庆生活
安庆公共频道	aqgg	安庆公共频道/安庆公共/安庆电视台公共频道/安庆电视台公共/安庆台公共频道/安庆台公共/安庆市公共频道/安庆市公共
高清剧场频道	szthm_yule	高清剧场频道/高清剧场/天天高清综艺/天华综艺/nvod剧场/天华高清剧场/天华剧场/天华高清综艺/天天高清剧场/华尚高清剧场/华尚高清剧院/dv高清剧场/天华天天剧场频道/天华天天剧场/天天剧场频道/天天剧场/剧场频道高清
粤语高清	thyyhd	粤语高清/天华高清粤语/高清粤语
永嘉新闻综合频道	yjxw	永嘉新闻综合频道/永嘉新闻综合/永嘉新闻频道/永嘉新闻/永嘉综合频道/永嘉综合/永嘉台新闻综合频道/永嘉台新闻综合/永嘉电视台新闻综合频道/永嘉电视台新闻综合/永嘉新闻台/永嘉综合台/永嘉台新闻综合台/永嘉电视台新闻综合台
辽宁导视频道	lndaoshi	辽宁导视频道/辽宁导视/北方导视频道/北方导视
KBS	kbs_world	kbs/kbs world/kbs韓國國際綜合高清頻道
深圳宜和购物	yhmall	深圳宜和购物/深圳宜和购物频道/宜和购物/深视宜和购物
东北戏曲	dbxq	东北戏曲
睛彩运城	jcyc	睛彩运城
星元少儿	xyse	星元少儿
购物频道2	gw2	购物频道2/导购二/益阳购物/好享购2/凤凰购物2/购物2/好享购物2/优惠促销/家源购物/24小时购房/三佳购物精品/亨通家家商城/好易购2/富阳购物/桐庐购物/好享购物二套/好享购物二
IPTV3PLUS	iptv3	iptv3plus
电竞天堂	djtt	电竞天堂
IPTV美食	meishi	iptv美食
IPTV旅游	lvyou	iptv旅游
呼和浩特影视娱乐	hhhttv3	呼和浩特影视娱乐/呼和浩特电视台影视娱乐频道/呼和浩特电视台影视娱乐/呼和浩特3/呼和浩特电视台影视频道/呼和浩特电视台影视/呼和浩特影视频道/呼和浩特影视/呼和浩特三台/呼和浩特三
睛彩山西	jcsx	睛彩山西
党建频道	djpd	党建频道/党建/先锋频道/先锋/菏泽党建/南阳党教
呼伦贝尔生活资讯	hlbrtv3	呼伦贝尔生活资讯/呼伦贝尔电视台生活资讯频道/呼伦贝尔电视台生活资讯/呼伦贝尔3
承德电视台1	chengdetv1	承德电视台1/承德电视台新闻综合频道/承德电视台新闻综合/承德新闻综合
沧州1	cztv1	沧州1/沧州电视台新闻综合频道/沧州电视台新闻综合/沧州一台/沧州一/沧州1套/沧州一套
松原经济频道	sytv2	松原经济频道/松原经济/松原电视台经济生活频道/松原电视台经济生活/sytv2/松原经济生活台/松原经济生活
盘锦三套	pjtv13	盘锦三套/盘锦三/盘锦电视台影视剧频道/盘锦电视台影视剧/盘锦电视台影视娱乐频道/盘锦电视台影视娱乐/盘锦影视娱乐频道/盘锦影视娱乐/盘锦影视频道/盘锦影视/盘锦三台
南通新闻综合频道	nttv1	南通新闻综合频道/南通新闻综合/南通电视台新闻综合频道/南通电视台新闻综合/南通一套/南通一/南通一台/南通新闻综合台
如皋新闻综合	rgxwzh	如皋新闻综合/如皋电视台新闻综合频道/如皋电视台新闻综合/如皋新闻台/如皋新闻/如皋新闻综合频道
鹰潭一套	yttv1	鹰潭一套/鹰潭一/鹰潭电视台新闻综合频道/鹰潭电视台新闻综合/鹰潭新闻综合频道/鹰潭新闻综合/鹰潭新闻综合台/鹰潭一台
鹰潭二套	yttv2	鹰潭二套/鹰潭二/鹰潭电视台公共频道/鹰潭电视台公共/鹰潭公共频道/鹰潭公共/鹰潭公共台/鹰潭二台
新余一套	jxxytv1	新余一套/新余一/新余电视台新闻综合频道/新余电视台新闻综合/新余电视台一套/新余电视台一/新余一台
新余二套	jxxytv2	新余二套/新余二/新余电视台公共频道/新余电视台公共/新余电视台二套/新余电视台二/新余二台
赣州一套	jxgztv1	赣州一套/赣州一/赣州电视台新闻综合频道/赣州电视台新闻综合/赣州一台
赣州二套	jxgztv2	赣州二套/赣州二/赣州电视台经济民生频道/赣州电视台经济民生/赣州二台
德阳财富频道	scdytv6	德阳财富频道/德阳财富/德阳电视台财富频道/德阳电视台财富/德阳财富台
德州公共频道	dztv3	德州公共频道/德州公共/德州电视台公共民生频道/德州电视台公共民生/德州民生频道/德州民生/德州生活台/德州生活
郴州公共都市	hncztv2	郴州公共都市/郴州电视台公共都市频道/郴州电视台公共都市/郴州公共都市台
郴州南岭生活	hncztv3	郴州南岭生活/郴州电视台南岭生活频道/郴州电视台南岭生活/郴州南岭生活台
株洲房产频道	hnzztv4	株洲房产频道/株洲房产/株洲电视台房产频道/株洲电视台房产/株洲房产台
株洲生活频道	hnzztv6	株洲生活频道/株洲生活/株洲电视台生活频道/株洲电视台生活/株洲生活台
济宁新闻综合频道	sdjntv1	济宁新闻综合频道/济宁新闻综合/济宁电视台新闻综合频道/济宁电视台新闻综合/济宁电视台一套/济宁电视台一/济宁一套/济宁一/济宁台一套/济宁台一/济宁电视台综合频道/济宁电视台综合/济宁一台
任城1台	sdjnrc1	任城1台/任城1
荆门综合频道	hbjmtv1	荆门综合频道/荆门综合/荆门电视台新闻综合频道/荆门电视台新闻综合/荆门新闻/荆门综合台
十堰公共频道	hbsytv2	十堰公共频道/十堰公共/十堰电视台公共频道/十堰电视台公共/十堰综合频道/十堰综合/十堰综合台
十堰影视频道	hbsytv7	十堰影视频道/十堰影视/十堰电视台影视频道/十堰电视台影视/十堰影视台
鹤壁新闻综合频道	hebitv1	鹤壁新闻综合频道/鹤壁新闻综合/鹤壁电视台新闻综合频道/鹤壁电视台新闻综合/鹤壁一套/鹤壁一/鹤壁电视台一套/鹤壁电视台一/鹤壁一台/鹤壁新闻综合台
周口公共频道	hnzktv2	周口公共频道/周口公共/周口电视台公共频道/周口电视台公共/周口二套/周口二/周口公共台
乐山新闻综合	leshantv1	乐山新闻综合/乐山电视台新闻综合频道/乐山电视台新闻综合
滨海一套	binhai2	滨海一套/滨海一/滨海1/滨海一台
东营公共频道	dytvca2	东营公共频道/东营公共/东营电视台公共频道/东营电视台公共/东营电视台二套/东营电视台二/东营2/东营二台/东营二
纪实天下	jstianxia	纪实天下
丽水公共频道	lsgg	丽水公共频道/丽水公共/丽水电视台新闻公共频道/丽水电视台新闻公共/丽水经济生活
吉安三套	jxjatv3	吉安三套/吉安三/吉安电视台三套/吉安电视台三/吉安图文
中国电影频道香港版	china_movie_channel	中国电影频道香港版
眉山综合频道	mstv1	眉山综合频道/眉山综合/眉山电视台新闻综合频道/眉山电视台新闻综合/眉山一台/眉山一
阳泉综合频道	yqtv1	阳泉综合频道/阳泉综合/阳泉电视台综合频道/阳泉电视台综合/阳泉一套/阳泉一/阳泉新闻综合/阳泉新闻台/阳泉新闻
阳泉科教频道	qtv2	阳泉科教频道/阳泉科教/阳泉电视台科教频道/阳泉电视台科教/阳泉电视台二套/阳泉电视台二/阳泉二台/阳泉二/阳泉科教台
辽阳教育科技	layatv3	辽阳教育科技/辽阳电视台教育科技频道/辽阳电视台教育科技/辽阳电视台教育频道/辽阳电视台教育/辽阳教育台/辽阳教育
钦州综合频道	qztvca1	钦州综合频道/钦州综合/钦州电视台综合频道/钦州电视台综合/钦州新闻综合
丽江综合频道	lijiangtv1	丽江综合频道/丽江综合/丽江电视台综合频道/丽江电视台综合/丽江综合台
射阳新闻综合频道	syxwzh	射阳新闻综合频道/射阳新闻综合/射阳电视台新闻综合频道/射阳电视台新闻综合/射阳新闻综合台
惊险影院	jxyingyuan	惊险影院/iptv惊险影院
武威公共频道	wwgg	武威公共频道/武威公共/武威电视台公共频道/武威电视台公共/武威公共台
潮安传承频道	chaantv2	潮安传承频道/潮安传承/潮安电视台传承频道/潮安电视台传承
河源公共频道	hyrtv2	河源公共频道/河源公共/河源电视台公共频道/河源电视台公共/河源公共台
阳煤电视台	qtv5	阳煤电视台/阳煤电视/阳煤集团有线电视台/阳煤集团有线电视
胜利图文频道	slyttv3	胜利图文频道/胜利图文/胜利电视台图文频道/胜利电视台图文/胜利电视三套/胜利电视三/胜利3/胜利三台/胜利三
绍兴县娱乐新干线	shaoxtv3	绍兴县娱乐新干线/绍兴县娱乐新干线频道/绍兴县娱乐新干线台
瑞安新闻综合	ruiantv	瑞安新闻综合/瑞安电视台新闻综合频道/瑞安电视台新闻综合/瑞安一台/瑞安一
内江影视文艺频道	neijtv2	内江影视文艺频道/内江影视文艺/内江电视台影视文艺频道/内江电视台影视文艺/内江影艺频道/内江影艺/内江影艺台
汕尾公共频道	swtv2	汕尾公共频道/汕尾公共/汕尾电视台公共频道/汕尾电视台公共/汕尾二套/汕尾二/汕尾二台
阜新社会生活频道	fxtv1	阜新社会生活频道/阜新社会生活/阜新电视台社会生活频道/阜新电视台社会生活/阜新社会生活台
酒泉公共频道	jiuquantv2	酒泉公共频道/酒泉公共/酒泉电视台公共频道/酒泉电视台公共/酒泉公共台
崇左新闻综合频道	gxcztv1	崇左新闻综合频道/崇左新闻综合/崇左电视台新闻综合频道/崇左电视台新闻综合/崇左新闻台/崇左新闻
电影一台	icable_movie1	电影一台/电影一/香港有线电影一台/香港有线电影一/香港有线宽频tbn/有线电视电影一台/有线电视电影一
滨海二套	binhai1	滨海二套/滨海二/滨海2/滨海二台
渭南综合频道	weinanzh	渭南综合频道/渭南综合/渭南新闻综合频道/渭南新闻综合/渭南1/渭南一台/渭南一/渭南综合台
北京生活频道	btv7	北京生活频道/北京生活/北京电视台生活频道/北京电视台生活/btv7/btv7生活/btv7台/btv7套/btv生活频道/btv生活/北京7台/北京7/北京7套/北京电视台七套/北京电视台七/北京七台/北京七/北京七套/北京台生活频道/北京台生活/北京生活台
BTV国际欧洲	btvgjoz	btv国际欧洲
福建家庭教育频道	fjtv10	福建家庭教育频道/福建家庭教育/福建电视台家庭教育频道/福建电视台家庭教育/福建电视台家教频道/福建电视台家教/福建家教台/福建家教
厦门新闻频道	xmtv1	厦门新闻频道/厦门新闻/厦门电视台新闻频道/厦门电视台新闻/厦门电视新闻频道/厦门电视新闻/厦门一套/厦门一/xmtv1/厦门新闻综合频道/厦门新闻综合/厦门1套/厦门1/厦门一台
厦门卫视	xmtv5	厦门卫视/厦门电视台厦门卫视/厦门电视卫视/福建厦门卫视/厦门电视台/厦门电视/厦门台/厦门/厦门tv
全心购物频道	qxgouwu	全心购物频道/全心购物
甘肃少儿频道	gstv3	甘肃少儿频道/甘肃少儿/甘肃电视台少儿频道/甘肃电视台少儿/甘肃台少儿频道/甘肃台少儿/甘肃少儿台/甘肃少儿电视台/甘肃少儿电视
珠江电影频道	zj_movie	珠江电影频道/珠江电影/珠江电影台/珠江影视频道/珠江影视
佛山新闻综合频道	gdfs1	佛山新闻综合频道/佛山新闻综合/佛山电视台新闻综合频道/佛山电视台新闻综合/佛山市新闻综合频道/佛山市新闻综合/广东佛山电视台新闻综合频道/广东佛山电视台新闻综合/佛山电视新闻综合频道/佛山电视新闻综合/佛山综合频道/佛山综合/佛山新闻频道/佛山新闻/gdfs1/佛山电视台/佛山电视
佛山顺德频道	gdfs5	佛山顺德频道/佛山顺德/佛山电视台顺德频道/佛山电视台顺德/佛山台顺德频道/佛山台顺德/广东佛山电视台顺德频道/广东佛山电视台顺德/gdfs5/顺德频道/顺德
江门综合频道	jmtv2	江门综合频道/江门综合/江门电视台综合频道/江门电视台综合
玉林新闻综合	gxyltv1	玉林新闻综合/玉林电视台新闻综合频道/玉林电视台新闻综合/玉林台新闻综合频道/玉林台新闻综合/玉林新闻频道/玉林新闻/玉林综合频道/玉林综合/玉林新闻综合台/玉林新闻台
玉林公共频道	gxyltv2	玉林公共频道/玉林公共/玉林电视台公共频道/玉林电视台公共/玉林台公共频道/玉林台公共/广西玉林公共频道/广西玉林公共/玉林公共台
海口经济频道	haikoutv3	海口经济频道/海口经济/海口电视台经济频道/海口电视台经济/海口三套/海口三/海口电视台3/海口三台/海口经济台/海口3套/海口3
河北都市频道	hebei3	河北都市频道/河北都市/河北电视台都市频道/河北电视台都市/河北台都市频道/河北台都市/河北三套/河北三/hebtv3/河北3套/河北3/河北都市台/河北三台
河北影视频道	hebei4	河北影视频道/河北影视/河北电视台影视频道/河北电视台影视/河北台影视频道/河北台影视/河北四套/河北四/hebtv4/河北4套/河北4/河北影视台/河北台影视台/河北四台
河北公共频道	hebei6	河北公共频道/河北公共/河北电视台公共频道/河北电视台公共/河北电视/河北台公共频道/河北台公共/hebtv6/河北六套/河北六/河北6套/河北6/河北综艺频道/河北综艺/河北公共台/河北六台
郑州妇女儿童频道	zhengzhoutv5	郑州妇女儿童频道/郑州妇女儿童/郑州电视台妇女儿童频道/郑州电视台妇女儿童/zztv5/zztv5政法频道/zztv5政法/郑视政法频道/郑视政法/郑州5套/郑州5/郑州电视台5套/郑州电视台5/郑州五套/郑州五/郑州电视台法制频道/郑州电视台法制/郑州政法频道/郑州政法/郑州五台
济源新闻综合	jytv1	济源新闻综合/济源电视台新闻综合频道/济源电视台新闻综合/济源1/河南济源电视
湖北垄上频道	hbls	湖北垄上频道/湖北垄上/湖北电视台垄上频道/湖北电视台垄上/垄上频道/垄上/垄上台
睛彩武汉频道	whtv9	睛彩武汉频道/睛彩武汉/武汉电视台睛彩武汉频道/武汉电视台睛彩武汉
襄阳影视娱乐频道	hbxytv4	襄阳影视娱乐频道/襄阳影视娱乐/襄阳电视台影视娱乐频道/襄阳电视台影视娱乐/襄阳4套/襄阳4/襄阳四套/襄阳四/襄阳四台
长沙经贸频道	changshawumon3	长沙经贸频道/长沙经贸/长沙电视台经贸频道/长沙电视台经贸/长沙台经贸频道/长沙台经贸/经贸频道/经贸/长沙经贸台/经贸台
江苏影视频道	jstv4	江苏影视频道/江苏影视/江苏电视台影视频道/江苏电视台影视/江苏电视影视频道/江苏电视影视/江苏影视台
南京少儿频道	njtv7	南京少儿频道/南京少儿/南京电视台少儿频道/南京电视台少儿/江苏南京少儿频道/江苏南京少儿/南京台少儿频道/南京台少儿
无锡生活频道	wuxi5	无锡生活频道/无锡生活/无锡电视台生活频道/无锡电视台生活/无锡台生活频道/无锡台生活/无锡生活健康频道/无锡生活健康/无锡生活台
江西红色经典频道	jxtv7	江西红色经典频道/江西红色经典/江西电视台红色经典频道/江西电视台红色经典/江西7/jxtv7/江西7套/江西七台/江西七
陶瓷频道	taoci	陶瓷频道/陶瓷/江西电视台陶瓷频道/江西电视台陶瓷/中国陶瓷
吉视乡村频道	jilin5	吉视乡村频道/吉视乡村/吉林电视台乡村频道/吉林电视台乡村/吉林乡村电视台/吉林乡村电视/吉林乡村频道/吉林乡村/吉林乡村台
辽宁经济频道	lntv_finance	辽宁经济频道/辽宁经济/辽宁电视台经济频道/辽宁电视台经济/沈阳经济频道/沈阳经济
大连文体频道	dalian4	大连文体频道/大连文体/大连电视台文体频道/大连电视台文体/dltv4/dltv文体频道/dltv文体/大连电视台4/大连文体台/大连足球频道/大连足球/大连4套/大连4/大连四套/大连四/大连4台/大连四台
大连少儿频道	dalian6	大连少儿频道/大连少儿/大连电视台动少儿频道/大连电视台动少儿/dltv6/dltv动漫频道/dltv动漫/大连电视台6/大连动漫台/大连动漫/大连六套/大连六/大连6套/大连6/大连六台/大连6台/大连动漫频道
抚顺新闻频道	lnfs1	抚顺新闻频道/抚顺新闻/抚顺电视台新闻频道/抚顺电视台新闻/lnfs新闻频道/lnfs新闻/抚顺电视台1/抚顺新闻台/抚顺电视台一套/抚顺电视台一/抚顺1台/抚顺1/抚顺一台/抚顺一/抚顺1套/抚顺一套
内蒙经济生活频道	nmgtv3	内蒙经济生活频道/内蒙经济生活/内蒙古电视台经济生活频道/内蒙古电视台经济生活/内蒙古电视台经济频道/内蒙古电视台经济/内蒙电视台生活频道/内蒙电视台生活/内蒙生活频道/内蒙生活/内蒙社会经济频道/内蒙社会经济/内蒙古社会经济频道/内蒙古社会经济/内蒙古经济生活/内蒙古经济生活频道/内蒙古电视台生活频道/内蒙古电视台生活/内蒙古生活频道/内蒙古生活
内蒙农牧频道	nmgtv5	内蒙农牧频道/内蒙农牧/内蒙古电视台农牧频道/内蒙古电视台农牧/内蒙影视剧电视台/内蒙影视剧电视/内蒙影视剧频道/内蒙影视剧/内蒙影视娱乐频道/内蒙影视娱乐/内蒙古影视娱乐频道/内蒙古影视娱乐/内蒙古影视剧频道/内蒙古影视剧/内蒙古农牧频道/内蒙古农牧
晋城信息频道	jctv3	晋城信息频道/晋城信息/晋城电视台图文信息频道/晋城电视台图文信息/山西晋城电视台信息频道/山西晋城电视台信息/晋城电视台三套/晋城电视台三/jctv3/晋城图文频道/晋城图文/晋城三台/晋城三
居家购物频道	sdcatv5	居家购物频道/居家购物/山东有线电视台居家购物频道/山东有线电视台居家购物/sdcatv居家购物频道/sdcatv居家购物/山东有线台居家购物频道/山东有线台居家购物/sdcatv5/山东有线电视第五频道/山东有线电视第五/山东电视居家购物频道/山东电视居家购物/山东电视居家购物台
演唱会	ych	演唱会
美食之旅	mszl	美食之旅
极速汽车	sitv9	极速汽车/sitv极速汽车/sitv极速汽车频道/上海极速汽车频道/上海极速汽车
新视觉	sitv30	新视觉/新视觉高清/上海新视觉/sitv新视觉高清频道/sitv新视觉高清/hd新视觉频道/hd新视觉/sitv新视觉/新视觉hd/新视觉英超/高清新视觉/新视觉综艺/英超新视觉/新视觉新英体育/英超高清/英超hd/高清英超/新视觉新英/英超直播/新英体育频道/新英体育
峨嵋电影频道	sctv8	峨嵋电影频道/峨嵋电影/四川电视台峨嵋电影频道/四川电视台峨嵋电影/四川台峨嵋电影频道/四川台峨嵋电影/四川电影频道/四川电影/峨眉电影/sctv峨眉/sctv峨眉电影/四川8
成都经济资讯频道	chengdu2	成都经济资讯频道/成都经济资讯/成都电视台经济资讯频道/成都电视台经济资讯/成都经济频道/成都经济/成都电台经济频道/成都电台经济/cdtv2/成都电视台资讯频道/成都电视台资讯/cdtv2经济频道/cdtv2经济
成都影视文艺频道	chengdu4	成都影视文艺频道/成都影视文艺/成都电视台影视文艺频道/成都电视台影视文艺/cdtv4/cdtv4影视文艺
天津文艺频道	tjtv3	天津文艺频道/天津文艺/天津电视台文艺频道/天津电视台文艺/天津文化娱乐频道/天津文化娱乐/天津电视文化娱乐频道/天津电视文化娱乐/tjtv2/天津二套/天津二/天津2套/天津2/天津二台/天津2台/天津电视台文化娱乐频道/天津电视台文化娱乐/天津文化娱乐台
天津影视频道	tjtv4	天津影视频道/天津影视/天津电视台影视频道/天津电视台影视/天津电视影视频道/天津电视影视/tjtv3/天津三套/天津三/天津3套/天津3/天津三台/天津3台/天津三套影视频道/天津三套影视/天津影视台
天津都市频道	tjtv5	天津都市频道/天津都市/天津电视台都市频道/天津电视台都市/天津电视都市频道/天津电视都市/天津四套/天津四/天津4套/天津4/天津四台/天津4台/tjtv4/天津四套都市频道/天津四套都市/天津都市台
天津体育频道	tjtv6	天津体育频道/天津体育/天津电视台体育频道/天津电视台体育/天津电视体育频道/天津电视体育/天津5台体育频道/天津5台体育/tjtv5/天津五套/天津五/天津5套/天津5/天津五台/天津5台/天津体育台
天津公共频道	tjtv9	天津公共频道/天津公共/天津电视台公共频道/天津电视台公共/天津台公共频道/天津台公共/天津八套公共频道/天津八套公共/tjtv公共/天津电视台八套公共频道/天津电视台八套公共/天津8套/天津8/天津八台/天津八/天津公共台
XJTV5	xjtv5	xjtv5/新疆电视台维语综艺频道/新疆电视台维语综艺/新疆电视台第五套频道综艺频道/新疆电视台第五套频道综艺/新疆电视台五频道/新疆电视台五/新疆电视台五套维语综艺频道/新疆电视台五套维语综艺/新疆台5频道/新疆台5/新疆维语综艺频道/新疆维语综艺/新疆五套/新疆五/新疆5套/新疆5/新疆5台/新疆五台/维吾尔语综艺频道/维吾尔语综艺
XJTV12	xjtv12	xjtv12/新疆电视台少儿频道/新疆电视台少儿/新疆电视台十二频道/新疆电视台十二/新疆电视台十二频道少儿频道/新疆电视台十二频道少儿/新疆电视台十二套少儿频道/新疆电视台十二套少儿/新疆少儿频道/新疆少儿/新疆台12频道/新疆台12/新疆12频道/新疆12/新疆十二台/新疆十二
云南娱乐频道	yntv3	云南娱乐频道/云南娱乐/云南电视台娱乐频道/云南电视台娱乐/yntv3/云南电视台旅游频道/云南电视台旅游/云南三套/云南三/云南3套/云南3/云南3台/云南三台/云南旅游民族/云南电视台三套娱乐频道/云南电视台三套娱乐/云南电视台旅游民族频道/云南电视台旅游民族/云南旅游民族频道/云南旅游频道/云南旅游
昆明新闻频道	kmtv1	昆明新闻频道/昆明新闻/昆明电视台新闻综合频道/昆明电视台新闻综合/kmtv1/昆明综合/昆明一套/昆明一/昆明1套/昆明1/昆明一台/昆明1台/昆明电视台综合频道/昆明电视台综合/昆明综合频道
昆明春城频道	kmtv6	昆明春城频道/昆明春城/昆明电视台春城频道/昆明电视台春城/kmtv6/昆明六套/昆明六/昆明6套/昆明6/昆明公共频道/昆明公共/昆明6台/昆明六台
浙江经视频道	zjtv3	浙江经视频道/浙江经视/浙江电视台经济生活频道/浙江电视台经济生活/浙江三套经济生活频道/浙江三套经济生活/cztv3/浙江经济生活频道/浙江经济生活/ztv3/浙江三台/浙江三
好易购频道	hyg	好易购频道/好易购/浙江电视台好易购频道/浙江电视台好易购
杭州生活频道	htv3	杭州生活频道/杭州生活/杭州电视台生活频道/杭州电视台生活/杭州台生活频道/杭州台生活/杭州电视生活频道/杭州电视生活/htv3/杭州电视综合生活频道/杭州电视综合生活/杭州电视台综合、生活频道/杭州电视台综合、生活/杭州三套/杭州三/杭州3套/杭州3/htv3杭州生活/杭州三台
杭州房产频道	htv66	杭州房产频道/杭州房产/杭州电视台房产频道/杭州电视台房产/杭州台房产频道/杭州台房产/杭州七套房产频道/杭州七套房产/htv7/杭州台房产台/杭州七套房台/杭州七套房
嘉兴文化影视	jiaxintv2	嘉兴文化影视/嘉兴电视台文化影视频道/嘉兴电视台文化影视/嘉兴台文化影视频道/嘉兴台文化影视/嘉兴文化频道/嘉兴文化/嘉兴影视频道/嘉兴影视/嘉兴文化台/嘉兴影视台
南宁公共频道	nanningtv4	南宁公共频道/南宁公共/南宁电视台公共频道/南宁电视台公共/南宁台公共频道/南宁台公共/广西南宁公共频道/广西南宁公共/南宁公共台
威海新闻频道	weihai1	威海新闻频道/威海新闻/威海电视台新闻综合频道/威海电视台新闻综合/威海1套/威海1/威海电视台一套/威海电视台一/威海一套/威海一/威海1台/威海一台/威海新闻综合频道/威海新闻综合
石家庄四套	shijiazhuang4	石家庄四套/石家庄四/石家庄电视台都市频道/石家庄电视台都市/石家庄电视台4/石家庄电视台4频道/石家庄电视台4套/石家庄电视台四套/石家庄电视台四/石家庄电视台四套都市频道/石家庄电视台四套都市/石家庄4套/石家庄4/石家庄四台/石家庄都市频道/石家庄都市/石家庄都市台
西安健康快乐频道	xian5	西安健康快乐频道/西安健康快乐/西安电视台健康快乐频道/西安电视台健康快乐/西安5台/西安5/西安5套/西安五套/西安五/西安五台/西安健康频道/西安健康/西安快乐频道/西安快乐/xatv5
西安音乐综艺频道	xian6	西安音乐综艺频道/西安音乐综艺/西安电视台音乐综艺频道/西安电视台音乐综艺/西安6台/西安6/西安6套/西安六套/西安六/西安电视台六套音乐综艺频道/西安电视台六套音乐综艺/xatv6/西安六台
汕头影视文艺	srttv3	汕头影视文艺/汕头电视台影视文艺频道/汕头电视台影视文艺/汕头3台/汕头3/汕头3套/汕头三套/汕头三/汕头影视文艺频道/汕头公共/汕头三台
DOXTV	doxtv	doxtv/音像世界/doxtv美剧频道/doxtv美剧/dox影画世界/doxtv音像世界/影像世界/doxtv 音像世界/dox音像世界/美剧剧场/音像世界doxtv
中国轻纺城频道	shaoxin4	中国轻纺城频道/中国轻纺城/绍兴中国轻纺城频道/绍兴中国轻纺城/浙江绍兴中国轻纺城频道/浙江绍兴中国轻纺城
京视剧场	bamc8	京视剧场/北京京视剧场频道/北京京视剧场/北京电视台京视剧场/btv京视剧场
时代出行	bamc18	时代出行/武汉数字电视时代出行频道/武汉数字电视时代出行/数字电视时代出行频道/数字电视时代出行/中国数字电视时代出行频道/中国数字电视时代出行/付费频道时代出行/武汉时代出行频道/武汉时代出行
昆明教育	ketv	昆明教育/昆明教育频道/ketv
海峡卫视	hxtv	海峡卫视/福建海峡卫视/海峡台/海峡电视台
海峡卫视国际频道	hxtv2	海峡卫视国际频道/海峡卫视国际/海峡卫视国际频道(亚洲)
睛彩甘肃频道	jingcaigansu	睛彩甘肃频道/睛彩甘肃
西宁新闻频道	xining_news	西宁新闻频道/西宁新闻/西宁电视台新闻频道/西宁电视台新闻/西宁新闻综合频道/西宁新闻综合/西宁新闻台/西宁新闻电视台/西宁新闻电视
永嘉影视娱乐频道	yjys	永嘉影视娱乐频道/永嘉影视娱乐/永嘉影视频道/永嘉影视/永嘉娱乐频道/永嘉娱乐/永嘉影视台/永嘉娱乐台
东方导视	shdstv	东方导视/ocn导视
邮轮旅游	gdylly	邮轮旅游/广东邮轮旅游/油轮旅游/广东电视台邮轮频道/广东电视台邮轮
DIVA UNIVERSAL	diva_universal	diva universal/diva universal频道/diva/diva universal 环球天后影剧频道/diva universal 环球天后影剧/diva universal 综合台/diva universal 综合/贺曼频道/贺曼/贺曼电影台/贺曼电影/diva uuiversal 環球天后影劇頻道/diva頻道/diva 天后影劇頻道/diva環球天后影劇頻道/diva環球天后/环球天后影剧频道/环球天后影剧
新闻录播	xwlb	新闻录播/全省地市新闻轮播/新闻回放/新闻轮播/精彩轮播/精品点播回放/全省新闻信息/镇街新闻轮播/新闻视线
吴江社会生活频道	wjtv2	吴江社会生活频道/吴江社会生活/吴江电视台社会生活频道/吴江电视台社会生活
竞G场	jgc	竞g场
湖北导视	hbdaoshi	湖北导视/湖北广电网络导视
NHK	nhk_world_premium	nhk/nhk world premium/nhk世界台/nhk世界/nhk电视台/nhk电视/nhk world premium 日本國家電視台/nhk world premium 日本國家電視
呼和浩特都市生活	hhhttv2	呼和浩特都市生活/呼和浩特电视台都市生活频道/呼和浩特电视台都市生活/呼和浩特2/呼和浩特电视台都市频道/呼和浩特电视台都市/呼和浩特二台/呼和浩特二
潮流购物	cxclgw	潮流购物
鞍山公共频道	ahshantv2	鞍山公共频道/鞍山公共/鞍山电视台公共频道/鞍山电视台公共
盐城七一小康频道	yanchengxk	盐城七一小康频道/盐城七一小康/盐城电视台七一小康频道/盐城电视台七一小康
乌鲁木齐生活服务	utv4	乌鲁木齐生活服务/乌鲁木齐电视台生活服务频道/乌鲁木齐电视台生活服务/乌鲁木齐都市频道/乌鲁木齐都市/乌鲁木齐台4/utv4/乌鲁木齐台四台/乌鲁木齐台四
北仑新闻综合频道	blxwzh	北仑新闻综合频道/北仑新闻综合/北仑电视台新闻综合频道/北仑电视台新闻综合/北仑新闻综合台
呼伦贝尔影视娱乐	hlbrtv2	呼伦贝尔影视娱乐/呼伦贝尔电视台影视娱乐频道/呼伦贝尔电视台影视娱乐/呼伦贝尔2
焦作娱乐频道	hnjztv3	焦作娱乐频道/焦作娱乐/焦作电视台娱乐频道/焦作电视台娱乐/焦作电视台三套/焦作电视台三/焦作三套/焦作三/焦作三台
张家口文化娱乐	zjktv2	张家口文化娱乐/张家口电视台文化娱乐频道/张家口电视台文化娱乐
沧州2	cztv2	沧州2/沧州电视台经济生活频道/沧州电视台经济生活/沧州二台/沧州二/沧州2套/沧州二套
盘锦一套	pjtv11	盘锦一套/盘锦一/盘锦电视台新闻频道/盘锦电视台新闻/盘锦新闻综合
盘锦二套	pjtv12	盘锦二套/盘锦二/盘锦电视台公共频道/盘锦电视台公共/盘锦都市生活/盘锦公共频道/盘锦公共/盘锦二台
齐齐哈尔新闻综合	qqhrtv1	齐齐哈尔新闻综合/齐齐哈尔电视台新闻综合频道/齐齐哈尔电视台新闻综合/齐齐哈尔新闻频道/齐齐哈尔新闻/齐齐哈尔1
南通生活频道	nttv3	南通生活频道/南通生活/南通电视台生活娱乐频道/南通电视台生活娱乐/南通三套/南通三/南通电视台生活频道/南通电视台生活/南通三台/南通生活台
芜湖新闻综合	wuhutv1	芜湖新闻综合/芜湖电视台新闻综合频道/芜湖电视台新闻综合/芜湖新闻频道/芜湖新闻
广安公共频道	scgatv2	广安公共频道/广安公共/广安电视台公共频道/广安电视台公共/广安公共台
南充公共频道	scnctv2	南充公共频道/南充公共/南充电视台公共频道/南充电视台公共/南充影视频道/南充影视/南充影视台
广元公共频道	scgytv2	广元公共频道/广元公共/广元电视台公共频道/广元电视台公共/广元公共台
广元影视频道	scgytv3	广元影视频道/广元影视/广元电视台影视文艺频道/广元电视台影视文艺/广元影视文艺台/广元影视文艺
揭阳公共频道	gdjytv2	揭阳公共频道/揭阳公共/揭阳电视台公共频道/揭阳电视台公共/揭阳台/揭阳
梅县影视频道	gdmxtv2	梅县影视频道/梅县影视/梅县电视台影视频道/梅县电视台影视
临沂财经频道	linyitv2	临沂财经频道/临沂财经/临沂电视台财经频道/临沂电视台财经/临沂电视台农科频道/临沂电视台农科/临沂农科/临沂农科频道
临沂影视频道	linyitv3	临沂影视频道/临沂影视/临沂电视台影视频道/临沂电视台影视/临沂导视资讯频道/临沂导视资讯
临沂公共频道	linyitv4	临沂公共频道/临沂公共/临沂电视台公共频道/临沂电视台公共
济宁生活频道	sdjntv2	济宁生活频道/济宁生活/济宁电视台生活频道/济宁电视台生活/济宁电视台二套/济宁电视台二/济宁二套/济宁二/济宁二台
任城2台	sdjnrc2	任城2台/任城2
北海新闻综合频道	bhtv1	北海新闻综合频道/北海新闻综合/北海电视台综合频道/北海电视台综合/北海电视台/北海电视
菏泽公共频道	hztv2	菏泽公共频道/菏泽公共/菏泽电视台公共频道/菏泽电视台公共/菏泽电视台二套/菏泽电视台二/菏泽二套/菏泽二/菏泽经济生活频道/菏泽经济生活/菏泽二台/菏泽公共台
许昌公共频道	hnxctv2	许昌公共频道/许昌公共/许昌电视台公共频道/许昌电视台公共/许昌二套/许昌二/许昌二台
濮阳科教频道	hnpytv3	濮阳科教频道/濮阳科教/濮阳电视台科教频道/濮阳电视台科教/濮阳三套/濮阳三/濮阳三台
驻马店新闻综合	zmdtv1	驻马店新闻综合/驻马店电视台新闻综合频道/驻马店电视台新闻综合/驻马店一套/驻马店一/驻马店一台
CQTV移动	cqtvyd	cqtv移动/重庆移动电视/重庆移动频道/重庆移动
赤峰经济频道	chifengjj	赤峰经济频道/赤峰经济/赤峰电视台经济频道/赤峰电视台经济/赤峰经济台
六安新闻频道	liuantv4	六安新闻频道/六安新闻/六安电视台新闻频道/六安电视台新闻
阳光卫视	chinasun1	阳光卫视/阳光卫视频道/阳光卫星电视/阳光卫星频道/阳光卫星/suntv/阳光电视台/阳光电视/阳光视讯
营口新闻频道	ykotv1	营口新闻频道/营口新闻/营口电视台新闻综合频道/营口电视台新闻综合/营口电视台一套/营口电视台一/营口1/营口一台/营口一
岳阳新闻综合频道	hbyytv1	岳阳新闻综合频道/岳阳新闻综合/岳阳电视台新闻频道/岳阳电视台新闻/岳阳新闻台/岳阳新闻
吉安一套	jxjatv1	吉安一套/吉安一/吉安电视台一套/吉安电视台一
随州综合频道	suizhoutv1	随州综合频道/随州综合/随州电视台新闻综合频道/随州电视台新闻综合
邹城三套	zcst	邹城三套/邹城三/邹城电视台三套/邹城电视台三/邹城tv3/邹城影视剧频道/邹城影视剧/邹城三台
阳泉影视频道	qtv3	阳泉影视频道/阳泉影视/阳泉电视台影视频道/阳泉电视台影视/阳泉电视台三套/阳泉电视台三/阳泉三台/阳泉三/阳泉影视台
宿迁公共频道	sqgg	宿迁公共频道/宿迁公共/宿迁电视台公共频道/宿迁电视台公共/宿迁公共台
佳木斯新闻综合	jmstv1	佳木斯新闻综合/佳木斯电视台新闻综合频道/佳木斯电视台新闻综合/佳木斯综合/佳木斯 新闻/佳木斯综合台/佳木斯新闻台/佳木斯新闻
佳木斯公共频道	jmstv2	佳木斯公共频道/佳木斯公共/佳木斯电视台公共频道/佳木斯电视台公共/佳木斯公共台
佳木斯影视频道	jmstv3	佳木斯影视频道/佳木斯影视/佳木斯电视台影视频道/佳木斯电视台影视/佳木斯影视台
长治文化频道	cztvca3	长治文化频道/长治文化/长治电视台文化频道/长治电视台文化/长治tv3/长治三台/长治三/长治文化台
胜利综合频道	slyttv1	胜利综合频道/胜利综合/胜利电视台综合频道/胜利电视台综合/胜利1/胜利一台/胜利一
普陀一套	zspttv1	普陀一套/普陀一/普陀电视台一套/普陀电视台一/普陀一台
瑞安文化经济	ruiantv2	瑞安文化经济/瑞安电视台文化经济频道/瑞安电视台文化经济/瑞安二台/瑞安二
毕节试验区公共台	bjtv2	毕节试验区公共台/毕节试验区公共/毕节试验区电视台公共频道/毕节试验区电视台公共
雅安公共频道	yaantv3	雅安公共频道/雅安公共/雅安电视台公共频道/雅安电视台公共/雅安电视台公共影视娱乐频道/雅安电视台公共影视娱乐/雅安公共影视娱乐频道/雅安公共影视娱乐/雅安公共台/雅安影视娱乐频道/雅安影视娱乐
白银综合频道	baiyintv1	白银综合频道/白银综合/白银电视台综合频道/白银电视台综合/白银综合台
江阴城市频道	jsjytv2	江阴城市频道/江阴城市/江阴电视台城市频道/江阴电视台城市/江阴资讯频道/江阴资讯/江阴资讯台
晋江侨乡频道	jinjiangtv1	晋江侨乡频道/晋江侨乡/晋江电视台侨乡频道/晋江电视台侨乡
宿州三套	suzhtv3	宿州三套/宿州三/宿州电视台三套/宿州电视台三/宿州三台
百色公共频道	bstv2	百色公共频道/百色公共/百色电视台公共频道/百色电视台公共/百色公共台
广东购物频道	gdtvmall	广东购物频道/广东购物
定州新闻综合	dzxwzh	定州新闻综合/定州电视台新闻综合
泰兴新闻频道	txxinwen	泰兴新闻频道/泰兴新闻/泰兴电视台新闻频道/泰兴电视台新闻
如东新闻综合	rudongxw	如东新闻综合/如东电视台新闻综合频道/如东电视台新闻综合
安徽科教频道	ahtv6	安徽科教频道/安徽科教/安徽电视台科教频道/安徽电视台科教/安徽电视台科学教诵频道/安徽电视台科学教诵/安徽台6频道/安徽台6/安徽台科教频道/安徽台科教/安徽科学教育频道/安徽科学教育/安徽电视科教频道/安徽电视科教/安徽科教台/安徽科学教育台/安徽电视科教台
合肥影院频道	hefeitv5	合肥影院频道/合肥影院/合肥电视台影院频道/合肥电视台影院/合肥家庭影院频道/合肥家庭影院/合肥台5频道/合肥台5/合肥台电视剧频道/合肥台电视剧/合肥台电影频道/合肥台电影/合肥台影院频道/合肥台影院/合肥家庭影院台/合肥台电视剧台/合肥台电影台
合肥故事休闲频道	hfstory	合肥故事休闲频道/合肥故事休闲/合肥电视台故事休闲频道/合肥电视台故事休闲/合肥休闲频道/合肥休闲/合肥休闲台
BTV纪实	btv12	btv纪实/北京电视台纪实频道/北京电视台纪实/btv纪实高清/北京电视台纪实高清频道/北京电视台纪实高清/北京纪实高清/北京纪实频道/北京纪实
BTV国际亚洲	btv11	btv国际亚洲
重庆影视频道	ccqtv2	重庆影视频道/重庆影视/重庆电视台影视频道/重庆电视台影视/重庆台影视频道/重庆台影视/重庆一套/重庆一/重庆1套/重庆1/cqtv1/cqtv影视/重庆一台
重庆都市频道	ccqtv5	重庆都市频道/重庆都市/重庆电视台都市频道/重庆电视台都市/重庆台都市频道/重庆台都市/重庆四套/重庆四/重庆4套/重庆4/cqtv4/cqtv－都市/cqtv都市
重庆手持电视频道	ccqtvyd	重庆手持电视频道/重庆手持电视/重庆电视台手持电视频道/重庆电视台手持电视/ctv手持电视/cqtv手持电视
东南卫视	fjtv2	东南卫视/东南电视台/东南电视/福建东南台/福建东南/福建东南卫视/福建东南卫视表/福建卫视/fjtv2/福建东南卫视卫星频道/福建东南卫视卫星/海鸥台/海鸥/福建2东南卫视/福建电视台/福建电视/东南台/东南tv/福建tv
福建经济频道	fjtv7	福建经济频道/福建经济/福建电视台经济频道/福建电视台经济/福建tv7频道/福建tv7/福建台经济生活频道/福建台经济生活/fjtv7/福建经济台/福建7经济生活/福建7经济/福建经济生活频道/福建经济生活
厦门国际频道	xmtv7	厦门国际频道/厦门国际/厦门电视台国际频道/厦门电视台国际
泉州都市生活频道	qztv2	泉州都市生活频道/泉州都市生活/泉州电视台都市生活频道/泉州电视台都市生活/泉州2套/泉州2/泉州电视台2/泉州电视台2套/泉州电视台二套/泉州电视台二/泉州二套/泉州二/泉州二台
广州竞赛频道	gztv3	广州竞赛频道/广州竞赛/广州电视台竞赛频道/广州电视台竞赛/广视竞赛频道/广视竞赛/广州竞赛台/广州体育/广州体育频道/广州体育台/gztv3
珠海新闻频道	zhtv1	珠海新闻频道/珠海新闻/珠海电视台新闻综合频道/珠海电视台新闻综合/珠海市电视台新闻综合频道/珠海市电视台新闻综合/珠海第一频道/珠海第一/zhtv1/珠海一套/珠海一/珠海1套/珠海1/珠海一台/珠海1台/珠海新闻综合/珠海新闻台
江门教育频道	jmtv3	江门教育频道/江门教育/江门电视台教育频道/江门电视台教育
贵视经济生活频道	gytv2	贵视经济生活频道/贵视经济生活/贵阳电视台经济生活频道/贵阳电视台经济生活/贵视台经济生活频道/贵视台经济生活/gytv2/贵阳2/贵阳二台/贵阳二
保定新闻频道	bdtv1	保定新闻频道/保定新闻/保定电视台新闻综合频道/保定电视台新闻综合/bdtv1/保定台新闻综合频道/保定台新闻综合/保定一套/保定一/保定一台/保定1台/保定1/保定1套
黑龙江影视	hljtv2	黑龙江影视/黑龙江电视台影视频道/黑龙江电视台影视/黑龙江2频道/黑龙江2/黑龙江电视2套/黑龙江电视2/黑龙江台影视频道/黑龙江台影视/hljtv2/黑龙江影视台
黑龙江文艺	hljtv3	黑龙江文艺/黑龙江电视台文艺频道/黑龙江电视台文艺/黑龙江3频道/黑龙江3/黑龙江电视3套/黑龙江电视3/黑龙江台文艺频道/黑龙江台文艺/hljtv3/黑龙江文艺台/龙视文艺频道/龙视文艺
黑龙江都市	hljtv4	黑龙江都市/黑龙江电视台都市频道/黑龙江电视台都市/黑龙江4频道/黑龙江4/黑龙江电视4套/黑龙江电视4/黑龙江台都市频道/黑龙江台都市/hljtv4/黑龙江都市台/龙视都市频道/龙视都市
黑龙江公共	hljtv6	黑龙江公共/黑龙江电视台公共频道/黑龙江电视台公共/黑龙江6频道/黑龙江6/黑龙江电视6套/黑龙江电视6/黑龙江电视收视指南/黑龙江电视台收视指南/黑龙江台公共频道/黑龙江台公共/hljtv6/黑龙江公共台/龙视公共频道/龙视公共
伊春新闻综合频道	yichuntv1	伊春新闻综合频道/伊春新闻综合/伊春电视台新闻综合频道/伊春电视台新闻综合/伊春电视/伊春台新闻综合频道/伊春台新闻综合/伊春综合频道/伊春综合
伊春公共频道	yichuntv2	伊春公共频道/伊春公共/伊春电视台伊春公共频道/伊春电视台伊春公共/伊春电视收视指南/伊春电视台收视指南/伊春台公共频道/伊春台公共
河南政法频道	hntv4	河南政法频道/河南政法/河南电视台政法频道/河南电视台政法/河南法制/河南4套/河南4/河南四套/河南四/河南法制频道4/河南电视台法制频道/河南电视台法制/hntv4/hntv4法制/河南电视台4/河南法制频道/河南四台
郑州时政频道	zhengzhoutv1	郑州时政频道/郑州时政/郑州电视台时政频道/郑州电视台时政/zztv1/zztv1新闻综合频道/zztv1新闻综合/郑视新闻综合频道/郑视新闻综合/郑州1套/郑州1/郑州电视台1套/郑州电视台1/郑州综合频道/郑州综合/郑州新闻频道/郑州新闻/郑州一套/郑州一/郑州电视台新闻综合频道/郑州电视台新闻综合/郑州新闻综合频道/郑州新闻综合/郑州一台
南阳科教频道	nytv3	南阳科教频道/南阳科教/南阳电视台科教频道/南阳电视台科教/nytv3/南阳电视台3套/南阳电视台3/南阳台精选文摘频道/南阳台精选文摘/南阳电视台精选文摘频道/南阳电视台精选文摘/南阳精选文摘频道/南阳精选文摘/南阳三台/南阳三
湖北影视频道	hubei3	湖北影视频道/湖北影视/湖北电视台影视频道/湖北电视台影视/湖北省电视台影视频道/湖北省电视台影视/湖北3台/湖北3/湖北三套/湖北三/hbtv3/湖北三台
湖南卫视美洲	hunantv10	湖南卫视美洲频道/湖南卫视美洲
经视都市频道	hnetv2	经视都市频道/经视都市/湖南经济电视台都市频道/湖南经济电视台都市/湖南etv直播都市频道/湖南etv直播都市/湖南经视直播都市/湖南经视直播都市频道/湖南经视都市/湖南经济都市/etv都市/湖南都市频道/湖南都市/湖南etv都市频道/湖南etv都市/湖南都市台
江苏城市频道	jstv3	江苏城市频道/江苏城市/江苏电视台城市频道/江苏电视台城市/江苏电视城市频道/江苏电视城市/江苏城市台
南京娱乐频道	njtv5	南京娱乐频道/南京娱乐/南京电视台娱乐频道/南京电视台娱乐/南京电视娱乐频道/南京电视娱乐/南京台娱乐频道/南京台娱乐
苏州文化生活频道	suzhoutv3	苏州文化生活频道/苏州文化生活/苏州电视台文化生活频道/苏州电视台文化生活/苏州台文化生活频道/苏州台文化生活/苏州生活频道/苏州生活/文化生活频道/文化生活/苏州三套/苏州三/苏州3套/苏州3/苏州三台
无锡新闻综合频道	wuxi1	无锡新闻综合频道/无锡新闻综合/无锡电视台新闻综合频道/无锡电视台新闻综合/无锡台新闻综合频道/无锡台新闻综合/无锡新闻综合台/无锡新闻/无锡新闻频道/无锡新闻台/无锡新闻综合高清
无锡娱乐频道	wuxi2	无锡娱乐频道/无锡娱乐/无锡电视台娱乐频道/无锡电视台娱乐/无锡台娱乐频道/无锡台娱乐/无锡电视娱乐频道/无锡电视娱乐/无锡娱乐台/江苏无锡娱乐频道/江苏无锡娱乐/无锡文体娱乐频道/无锡文体娱乐/江苏无锡娱乐台
江西指南频道	jxtv_guide	江西指南频道/江西指南/江西电视指南频道/江西电视指南
长春四套	ctv4	长春四套/长春四/长春电视台四套/长春电视台四/长春电视台ctv4/长春电视台商业频道/长春电视台商业/长视四套/长视四/长春4套/长春4/长春四台/长春4台/长春商业/长春影视频道/长春影视/长春商业台/长春影视台
丹东新闻频道	ddtv1	丹东新闻频道/丹东新闻/丹东电视台新闻综合频道/丹东电视台新闻综合/ddtv新闻频道/ddtv新闻/丹东电视台1/丹东新闻台/丹东电视台一套新闻综合频道/丹东电视台一套新闻综合/丹东一套/丹东一/丹东电视台一套/丹东电视台一/丹东一台/丹东1套/丹东1/丹东1台
铁岭综合频道	tieling1	铁岭综合频道/铁岭综合/铁岭电视台新闻综合频道/铁岭电视台新闻综合/铁视1套/铁视1/铁岭1台/铁岭1/铁岭一台/铁岭一/铁岭一套/铁岭电视台综合频道/铁岭电视台综合/铁视一套/铁视一
内蒙文体频道	nmgtv4	内蒙文体频道/内蒙文体/内蒙古电视台文体频道/内蒙古电视台文体/内蒙文体娱乐台/内蒙文体娱乐/内蒙古文体娱乐频道/内蒙古文体娱乐/内蒙文体休闲频道/内蒙文体休闲/内蒙古电视台文体娱乐频道/内蒙古电视台文体娱乐
内蒙少儿频道	nmgtv6	内蒙少儿频道/内蒙少儿/内蒙古电视台少儿频道/内蒙古电视台少儿/内蒙古少儿电视台/内蒙古少儿电视/内蒙少儿台/内蒙古少儿频道/内蒙古少儿/nmtv少儿
山西少儿频道	sxtv6	山西少儿频道/山西少儿/山西电视台少儿频道/山西电视台少儿
DMC电影频道	dmcmovie	dmc电影频道/dmc电影/山西电影轮播/dmc轮播电影频道/dmc轮播电影
太原百姓频道	sxtytv2	太原百姓频道/太原百姓/山西太原电视台百姓频道/山西太原电视台百姓/太原电视台百姓频道/太原电视台百姓/太原2套/太原2/太原二套/太原二/太视二台/太视二/太原台百姓频道/太原台百姓/太原2台
山东体育频道	sdtv3	山东体育频道/山东体育/山东电视台体育频道/山东电视台体育/sdtv体育频道/sdtv体育/山东台体育频道/山东台体育/山东体育台
山东公共频道	sdtv5	山东公共频道/山东公共/山东电视台公共频道/山东电视台公共/sdtv公共新闻频道/sdtv公共新闻/山东电视台公共新闻频道/山东电视台公共新闻/山东台公共新闻频道/山东台公共新闻/山东公共台/sdtv公共
山东影视频道	sdtv7	山东影视频道/山东影视/山东电视台影视频道/山东电视台影视/山东电视台影视剧场/山东六影视频道/山东六影视/sdtv影视/山东影视台
雅趣综艺	doxyaqu	雅趣综艺
济南教育频道	jnetv	济南教育频道/济南教育/济南教育电视台/济南教育电视
历城导视频道	lcds	历城导视频道/历城导视/历城电视台导视频道/历城电视台导视/历城数字频道/历城数字
潍坊潍城频道	wfwc	潍坊潍城频道/潍坊潍城/潍坊电视台潍城频道/潍坊电视台潍城/潍城频道/潍城
日照生活频道	rizhao2	日照生活频道/日照生活/日照电视台科教频道/日照电视台科教/日照科教频道/日照科教
上海教育台	shedu1	上海教育台/上海教育/上海教育电视台/上海教育电视/上海台教育频道/上海台教育/上视电视台教育频道/上视电视台教育/上视教育台/上视教育
生活时尚	sitv10	生活时尚/新视觉时尚/新视觉hd时尚
陕西七套	shxitv8	陕西七套/陕西七/陕西电视台体育健康频道/陕西电视台体育健康/陕视体育健康频道/陕视体育健康/陕西电视台7套/陕西电视台7/陕西台体育健康频道/陕西台体育健康/陕西体育健康频道/陕西体育健康/陕西体育频道/陕西体育/陕西七台/陕西7台/陕西7/陕西7套/sxtvs7
陕西农林卫视	shxitv9	陕西农林卫视/陕西电视台农林科技卫视/陕视农林科技卫视/陕西农林科技卫视/陕西台农林卫视/农林科技/陕西农林/农林卫视
四川影视文艺频道	sctv5	四川影视文艺频道/四川影视文艺/四川电视台影视文艺频道/四川电视台影视文艺/sctv5/sctv5影视文艺频道/sctv5影视文艺/四川电视台5套/四川电视台5/四川台影视文艺频道/四川台影视文艺/四川影视/四川五套/四川五/四川5套/四川5/四川5台/四川五台/四川影视五台/四川影视五/四川影视5台/四川影视5
四川科教频道	sctv_8	四川科教频道/四川科教/四川科技教育频道/四川科技教育/sctv科教/sctv8
成都都市生活频道	chengdu3	成都都市生活频道/成都都市生活/成都电视台都市生活频道/成都电视台都市生活/成都电视台电视节目/cdtv3/成都生活频道/成都生活/成都都市频道/成都都市/cdtv3都市生活/cdtv3综合频道/cdtv3综合
XJTV6	xjtv6	xjtv6/新疆电视台汉语影视频道/新疆电视台汉语影视/新疆电视台第六频道汉语影视频道/新疆电视台第六频道汉语影视/新疆电视台六频道/新疆电视台六/新疆电视台六套汉语影视频道/新疆电视台六套汉语影视/新疆汉语影视频道/新疆汉语影视/新疆台6频道/新疆台6/新疆6套/新疆6/新疆六套/新疆六/新疆6台/新疆六台
XJTV11	xjtv11	xjtv11/新疆电视台法制信息频道/新疆电视台法制信息/新疆电视台十一频道/新疆电视台十一/新疆电视台十一频道法制信息频道/新疆电视台十一频道法制信息/新疆电视台十一套法制信息频道/新疆电视台十一套法制信息/新疆法制信息频道/新疆法制信息/新疆台11频道/新疆台11
云南生活频道	yntv4	云南生活频道/云南生活/云南电视台生活频道/云南电视台生活/yntv4/云南电视台体育频道/云南电视台体育/云南生活资讯频道/云南生活资讯/云南四套/云南四/云南4套/云南4/云南四台/云南电视台体育娱乐频道/云南电视台体育娱乐/云南体育娱乐频道/云南体育娱乐/云南体育频道/云南体育/云南生活台
湖州服务导视	huzhoutv5	湖州服务导视/湖州电视台服务导视频道/湖州电视台服务导视/湖州总台导视
西藏影视文化频道	xizangtv3	西藏影视文化频道/西藏影视文化/西藏电视台影视文化频道/西藏电视台影视文化/西藏电视台3/西藏三套/西藏三/西藏台影视文化频道/西藏台影视文化/西藏电视台三套影视文化频道/西藏电视台三套影视文化/西藏三台/西藏影视台/西藏影视
牡丹江公共频道	moudanjian2	牡丹江公共频道/牡丹江公共/牡丹江电视台公共频道/牡丹江电视台公共/牡丹江台公共频道/牡丹江台公共/牡丹江公共台
南宁影视娱乐频道	nanningtv2	南宁影视娱乐频道/南宁影视娱乐/南宁电视台影视娱乐频道/南宁电视台影视娱乐/南宁台影视娱乐频道/南宁台影视娱乐/南宁影视/南宁影视频道/南宁娱乐频道/南宁娱乐/南宁影视娱乐台/南宁影视台/南宁娱乐台
枣庄新闻频道	zaozhuang3	枣庄新闻频道/枣庄新闻/枣庄电视台新闻频道/枣庄电视台新闻/枣庄台新闻频道/枣庄台新闻/枣庄新闻电视台/枣庄新闻电视/枣庄新闻台
延边商务	ybswpd	延边商务/延边商务频道
信阳综合频道	xinyang1	信阳综合频道/信阳综合/信阳电视台新闻综合频道/信阳电视台新闻综合/河南信阳台综合频道/河南信阳台综合/信阳新闻综合
秦皇岛政法台	qinhuangdao2	秦皇岛政法台/秦皇岛政法/秦皇岛电视台政法频道/秦皇岛电视台政法/秦皇岛2台/秦皇岛2/秦皇岛2套/秦皇岛二套/秦皇岛二/秦皇岛政法频道/qhd2/秦皇岛电视台2/秦皇岛二台
CHC动作电影	chc1	chc动作电影/chc动作电影频道/chc动作影院/chc电影台/chc电影/chc动作频道/chc动作/华诚动作电影
时代家居	bamc17	时代家居/天津电视台时代家居频道/天津电视台时代家居/天津时代家居频道/天津时代家居/数字电视时代家居/中国数字电视时代家居频道/中国数字电视时代家居
时代美食	bamc20	时代美食/鼎视传媒时代美食
南昌数字频道	nanchang_digital	南昌数字频道/南昌数字/南昌电视台数字频道/南昌电视台数字/南昌数字电视
网络棋牌	gtv_qipai	网络棋牌/gtv网络棋牌/gtv网络棋牌频道/网络棋牌频道/sitv网络棋牌
现代教育频道	fun_tv	现代教育频道/现代教育/广东电视台现代教育频道/广东电视台现代教育/广东快乐益智频道/广东快乐益智/广东电视台快乐益智频道/广东电视台快乐益智/快乐益智
西宁生活频道	xining_life	西宁生活频道/西宁生活/西宁电视台生活频道/西宁电视台生活/西宁生活台/西宁生活电视台/西宁生活电视/西宁生活服务
安庆图文频道	aqtw	安庆图文频道/安庆图文/安庆电视台图文信息频道/安庆电视台图文信息/安庆广播电视台图文信息频道/安庆广播电视台图文信息/安庆信息频道/安庆信息/安庆图文信息频道/安庆图文信息
黄河卫视	hhws	黄河卫视/黄河电视台/黄河电视/山西黄河频道/山西黄河/黄河台/黄河tv
三佳购物	ttcjmall	三佳购物/河北购物频道/河北购物
南方购物	nfgw	南方购物/tvs东方购物
精品剧场	hsjpjc	精品剧场/华数精品剧场/精选剧场
鼎级剧场	dingjijc	鼎级剧场
数码时代	digital_era	数码时代
赛事精选3	ssjx3	赛事精选3
安徽综艺频道	ahtv4	安徽综艺频道/安徽综艺/安徽电视台综艺频道/安徽电视台综艺/ahtv文体频道/ahtv文体/安徽台4频道/安徽台4/安徽台文体频道/安徽台文体/ahtv4/安徽文体频道/安徽文体/安徽文体台
清远公共频道	gdqytv2	清远公共频道/清远公共/清远电视台公共频道/清远电视台公共
吉林市科教频道	jlctv2	吉林市科教频道/吉林市科教/吉林市电视台科教频道/吉林市电视台科教/吉林市科教台
包头文体娱乐频道	bttv_2	包头文体娱乐频道/包头文体娱乐/包头电视台文体娱乐频道/包头电视台文体娱乐/包头二套/包头二/包头电视台二套/包头电视台二/包头文娱生活/包头生活服务频道/包头生活服务/包头二台
包头经济生活频道	bttv_3	包头经济生活频道/包头经济生活/包头电视台经济生活频道/包头电视台经济生活/包头三套/包头三/包头电视台三套/包头电视台三/包头经济/包头三台
扬州城市频道	yztv2	扬州城市频道/扬州城市/扬州电视台城市频道/扬州电视台城市/扬州二套/扬州二/扬州二台
天长综合频道	ahtctv1	天长综合频道/天长综合/天长电视台新闻综合频道/天长电视台新闻综合/天长综合台
台州城市生活	taizhou4	台州城市生活/台州电视台城市生活频道/台州电视台城市生活/台州资讯/台州城市生活台
泰州三套	tztv3	泰州三套/泰州三/泰州电视台影视娱乐频道/泰州电视台影视娱乐/泰州影视娱乐
廊坊电视台一套	lftv1	廊坊电视台一套/廊坊电视台一/廊坊电视台新闻综合频道/廊坊电视台新闻综合/廊坊新闻
廊坊电视台二套	lftv2	廊坊电视台二套/廊坊电视台二/廊坊电视台公共频道/廊坊电视台公共
宁德公共影视频道	fjndtv2	宁德公共影视频道/宁德公共影视/宁德电视台公共影视频道/宁德电视台公共影视/宁德2/宁德二台/宁德二
焦作生活频道	hnjztv2	焦作生活频道/焦作生活/焦作电视台公共生活频道/焦作电视台公共生活/焦作电视台二套/焦作电视台二/焦作二套/焦作二/焦作公共频道/焦作公共/焦作二台
FOX体育二台	star_sports_cn	fox体育二台/fox体育二/espn体育/espn体育台/卫视体育台湾/star sports sea/fox體育2台/fox體育2/fox sport 2/fox sports2
沧州3	cztv3	沧州3/沧州电视台影视娱乐频道/沧州电视台影视娱乐/沧州三台/沧州三/沧州3套/沧州三套
乌海都市生活频道	wuhaitv2	乌海都市生活频道/乌海都市生活/乌海电视台都市生活频道/乌海电视台都市生活
齐齐哈尔影视文艺	qqhrtv3	齐齐哈尔影视文艺/齐齐哈尔电视台影视文艺频道/齐齐哈尔电视台影视文艺/齐齐哈尔影视频道/齐齐哈尔影视/齐齐哈尔3/齐齐哈尔影视台/齐齐哈尔三台/齐齐哈尔三
淮安公共频道	hatv2	淮安公共频道/淮安公共/淮安电视台公共频道/淮安电视台公共/淮安公共台
江海明珠	jhmz	江海明珠
镇江民生频道	zhenjiangtv2	镇江民生频道/镇江民生/镇江电视台民生频道/镇江电视台民生/镇江二套/镇江二/镇江二台
英语专题辅导	yy	英语专题辅导/自学引擎9/中考辅导英语
淮南经济生活	huainantv2	淮南经济生活/淮南电视台经济生活频道/淮南电视台经济生活/淮南二套/淮南二/淮南二台
自贡公共频道	sczgtv2	自贡公共频道/自贡公共/自贡电视台公共频道/自贡电视台公共
萍乡综合频道	pxitv1	萍乡综合频道/萍乡综合/萍乡电视台新闻综合频道/萍乡电视台新闻综合/pxtv1/萍乡新闻综合台/萍乡新闻综合
萍乡科教频道	pxitv4	萍乡科教频道/萍乡科教/萍乡电视台科教频道/萍乡电视台科教/pxtv3/萍乡科教台
梧州公共频道	gxwztv2	梧州公共频道/梧州公共/梧州电视台公共频道/梧州电视台公共
梧州教育生活频道	gxwztv3	梧州教育生活频道/梧州教育生活/梧州电视台教育生活频道/梧州电视台教育生活
德州图文频道	dztv2	德州图文频道/德州图文/德州电视台图文频道/德州电视台图文/德州电视图文频道/德州电视图文/德州影视频道/德州影视/德州娱乐台/德州娱乐
韶关新闻综合频道	gdsgtv1	韶关新闻综合频道/韶关新闻综合/韶关电视台新闻综合频道/韶关电视台新闻综合/韶关综合/韶关新闻综合台
湘潭新闻频道	hnxttv1	湘潭新闻频道/湘潭新闻/湘潭电视台新闻综合频道/湘潭电视台新闻综合/湘潭电视台新闻频道/湘潭电视台新闻
任城3台	sdjnrc3	任城3台/任城3
黄石新闻频道	hbhstv1	黄石新闻频道/黄石新闻/黄石电视台新闻频道/黄石电视台新闻/黄石新闻综合
黄石移动频道	hsyd	黄石移动频道/黄石移动/黄石电视台移动频道/黄石电视台移动/黄石移动台
十堰经济频道	hbsytv3	十堰经济频道/十堰经济/十堰电视台经济频道/十堰电视台经济/十堰经济生活频道/十堰经济生活/十堰电视台经济旅游频道/十堰电视台经济旅游/十堰经济生活台
周口图文频道	hnzktv3	周口图文频道/周口图文/周口电视台图文频道/周口电视台图文/周口三套/周口三/周口图文台
周口教育频道	hnzktv4	周口教育频道/周口教育/周口电视台教育频道/周口电视台教育/周口四套/周口四/周口教育台
咸阳新闻综合频道	sxxytv1	咸阳新闻综合频道/咸阳新闻综合/咸阳电视台新闻综合频道/咸阳电视台新闻综合/咸阳一套/咸阳一/咸阳一台
咸阳市民频道	sxxytv3	咸阳市民频道/咸阳市民/咸阳电视台市民频道/咸阳电视台市民/咸阳三套/咸阳三/咸阳三台
东营教育频道	dytvca4	东营教育频道/东营教育/东营新型农民教育频道/东营新型农民教育
NEWTV中国功夫	zggongfu	newtv中国功夫
NEWTV搏击	sjboji	newtv搏击
岳阳科教频道	hbyytv3	岳阳科教频道/岳阳科教/岳阳电视台经济科教频道/岳阳电视台经济科教/岳阳电视台科教频道/岳阳电视台科教/岳阳科教台
商丘综合频道	sqtvca1	商丘综合频道/商丘综合/商丘新闻综合频道/商丘新闻综合/商丘综合台
好莱坞电影	haolaiwu1	好莱坞电影/山东有线好莱坞电影
邹城一套	zcyt	邹城一套/邹城一/邹城电视台新闻综合频道/邹城电视台新闻综合/邹城tv1/邹城新闻综合频道/邹城新闻综合/邹城一台/邹城新闻综合台
邹城二套	zcet	邹城二套/邹城二/邹城电视台二套/邹城电视台二/邹城tv2/邹城文化生活频道/邹城文化生活/邹城二台
澳门卫视	mastv2	澳门卫视/香港有线宽频澳门卫星频道/香港有线宽频澳门卫星/mstv
情感驿站	qingganyz	情感驿站
张家港新闻综合	zjgxwzh	张家港新闻综合/张家港电视台新闻综合频道/张家港电视台新闻综合
昆山新闻综合	ksxwzh	昆山新闻综合
长兴新闻频道	changxtv1	长兴新闻频道/长兴新闻/长兴电视台新闻综合频道/长兴电视台新闻综合/长兴新闻台
铜仁新闻综合频道	trtv1	铜仁新闻综合频道/铜仁新闻综合/铜仁电视台新闻综合频道/铜仁电视台新闻综合/铜仁新闻台/铜仁新闻
遂宁公共频道	uiningtv2	遂宁公共频道/遂宁公共/遂宁电视台公共频道/遂宁电视台公共/遂宁公共台
太仓新闻频道	tcxwpd	太仓新闻频道/太仓新闻/太仓电视台新闻频道/太仓电视台新闻/太仓新闻综合频道/太仓新闻综合/太仓新闻台
淮北教育频道	ahhbtv3	淮北教育频道/淮北教育/淮北电视台教育频道/淮北电视台教育
宿州一套	suzhtv1	宿州一套/宿州一/宿州电视台一套/宿州电视台一/宿州新闻
宿州二套	suzhtv2	宿州二套/宿州二/宿州电视台二套/宿州电视台二/宿州二台
六安少儿频道	liuantv3	六安少儿频道/六安少儿/六安电视台少儿教育频道/六安电视台少儿教育/六安少儿教育频道/六安少儿教育/六安少儿教育台
防城港新闻综合	fcgtv1	防城港新闻综合/防城港电视台新闻综合频道/防城港电视台新闻综合/防城港新闻台/防城港新闻
防城港公共频道	fcgtv2	防城港公共频道/防城港公共/防城港电视台公共频道/防城港电视台公共/防城港公共台
定州生活	dzshenghuo	定州生活/定州电视台生活
溧水新闻综合	lishuixw	溧水新闻综合/溧水电视台新闻综合频道/溧水电视台新闻综合
灌云新闻综合频道	guanyunxw	灌云新闻综合频道/灌云新闻综合/灌云电视台新闻综合频道/灌云电视台新闻综合
海门新闻综合	haimenxw	海门新闻综合/海门电视台新闻综合频道/海门电视台新闻综合/海门新闻综合频道
安徽经济生活频道	ahtv2	安徽经济生活频道/安徽经济生活/安徽电视台经济生活频道/安徽电视台经济生活/安徽经济频道/安徽经济/安徽经视/安徽经视频道/安徽台2频道/安徽台2/安徽台经济生活频道/安徽台经济生活/安徽生活频道/安徽生活/安徽经济台/安徽经济生活台/安徽生活台
北京青年频道	btv8	北京青年频道/北京青年/北京电视台青年频道/北京电视台青年/btv8/btv8台/btv8套/btv青少/btv青少频道/北京八台/北京八/北京八套/北京电视台八套/北京电视台八/北京台青少频道/北京台青少/btv青年/北京青少频道/北京青少/北京电视台青少频道/北京电视台青少
福州少儿频道	fztv_baby	福州少儿频道/福州少儿/福州电视台少儿频道/福州电视台少儿/fztv4
福州导视频道	fzdstv	福州导视频道/福州导视
厦门卫视美洲	xmtv9	厦门卫视美洲
泉州综合频道	qztv1	泉州综合频道/泉州综合/泉州电视台综合频道/泉州电视台综合/泉州1套/泉州1/泉州电视台1/泉州电视台1套/泉州电视台一套/泉州电视台一/泉州一套/泉州一/泉州新闻综合/泉州新闻综合频道/qztv1/泉州一台
南平新闻综合	nptv1	南平新闻综合/南平电视台新闻综合频道/南平电视台新闻综合/福建南平电视台/福建南平电视
嘉佳卡通频道	gdtv7	嘉佳卡通频道/嘉佳卡通/嘉佳卡通卫视/嘉佳卡通台/广东嘉佳卡通频道/广东嘉佳卡通/gdtv6/广东卡通频道/广东卡通
广东国际频道	gdtv8	广东国际频道/广东国际/广东电视台国际频道/广东电视台国际/gdtv world
深圳卫视香港	sztv1_hk	深圳卫视香港
深视少儿频道	sztv7	深视少儿频道/深视少儿/深圳电视台少儿频道/深圳电视台少儿/sztv/深视六套/深视六/深圳6套/深圳6/深圳6套少儿频道/深圳6套少儿/深圳六台/深圳六/深圳少儿频道/深圳少儿/sztv6/深圳六套/深圳6台
广州综合频道	gztv1	广州综合频道/广州综合/广州电视台综合频道/广州电视台综合/广东电视台34频道/广东电视台34/广视综合频道/广视综合/广州电视台34频道/广州电视台34/广州市电视台34频道/广州市电视台34/广州卫视综合频道/广州卫视综合/gztv1/广州综合台/广州台/广州/广州电视台/广州电视/广州tv
珠海生活频道	zhtv2	珠海生活频道/珠海生活/珠海电视台生活服务频道/珠海电视台生活服务/珠海市电视台生活服务频道/珠海市电视台生活服务/珠海第2频道/珠海第2/珠海第二频道/珠海第二/生活服务频道/生活服务/珠海二台/珠海二/珠海生活台/生活服务台
珠海文教频道	zhtv4	珠海文教频道/珠海文教/珠海电视台文教频道/珠海电视台文教/导视珠海频道/导视珠海/珠海3
湛江公共频道	gdzj2	湛江公共频道/湛江公共/湛江电视台公共频道/湛江电视台公共/广东湛江电视台公共频道/广东湛江电视台公共/gdzj2/广东湛江公共频道/广东湛江公共
广西公共频道	guanxi4	广西公共频道/广西公共/广西电视台公共频道/广西电视台公共/gxtv 公共频道/gxtv 公共/广西台公共频道/广西台公共/广西台公共台
广西影视频道	guanxi5	广西影视频道/广西影视/广西电视台影视频道/广西电视台影视/gxtv 影视频道/gxtv 影视/广西台影视频道/广西台影视/广西影视台
广西新闻频道	guanxi7	广西新闻频道/广西新闻/广西电视台新闻频道/广西电视台新闻/gxtv 经济频道/gxtv 经济/广西台经济频道/广西台经济/广西经济频道/广西经济/广西资讯频道/广西资讯/广西经济台/广西资讯台
玉林知识频道	gxyltv3	玉林知识频道/玉林知识/玉林电视台知识频道/玉林电视台知识/玉林台知识频道/玉林台知识/广西玉林电视台知识频道/广西玉林电视台知识/玉林台知识台
海南公共频道	hainantv3	海南公共频道/海南公共/海南电视台公共频道/海南电视台公共/海南电视台生活综艺频道/海南电视台生活综艺/海南电视台二套/海南电视台二/海南二套公共/海南电视台2/海南生活综艺台/海南生活综艺/海南二台/海南二
海南影视频道	hnysj	海南影视频道/海南影视/海南电视台影视综艺频道/海南电视台影视综艺/海南三套影视剧/海南电视台影视剧频道/海南电视台影视剧/海南影视剧频道/海南影视剧/海南电视台3/海南影视剧台/海南三台/海南三
河北经济频道	hebei2	河北经济频道/河北经济/河北电视台经济频道/河北电视台经济/河北经济电视台/河北经济电视/河北台经济生活频道/河北台经济生活/hebtv2/河北生活频道/河北生活/河北二台/河北二/河北二套/河北经济生活频道/河北经济生活/河北经济台/河北生活台
保定生活频道	bdtv2	保定生活频道/保定生活/保定电视台经济生活频道/保定电视台经济生活/bdtv2/保定台都市频道/保定台都市/保定二套/保定二/保定2套/保定2/保定2台/保定二台/保定经济生活频道/保定经济生活
精彩导视	jcdaoshi	精彩导视/黑龙江电视台精彩频道/黑龙江电视台精彩
哈尔滨新闻综合	hrbtv1	哈尔滨新闻综合/哈尔滨电视台新闻综合频道/哈尔滨电视台新闻综合/哈尔滨台新闻综合频道/哈尔滨台新闻综合/哈尔滨新闻频道/哈尔滨新闻/哈尔滨综合频道/哈尔滨综合/hrbtv1/哈尔滨综合频
哈尔滨资讯频道	hrbtv2	哈尔滨资讯频道/哈尔滨资讯/哈尔滨电视台都市资讯频道/哈尔滨电视台都市资讯/哈尔滨台都市资讯频道/哈尔滨台都市资讯/hrbtv2/哈尔滨都市资讯频道/哈尔滨都市资讯/哈尔滨都市
哈尔滨影视频道	hrbtv5	哈尔滨影视频道/哈尔滨影视/哈尔滨电视台影视频道/哈尔滨电视台影视/哈尔滨台滨影视频道/哈尔滨台滨影视/哈尔滨影视台
河南卫视	hntv1	河南卫视/河南卫视频道/河南卫星电视/河南卫星频道/河南卫星/大象台/大象/hntv1河南卫视/河南电视台/河南电视/河南台/河南tv
开封城区生活频道	kftv2	开封城区生活频道/开封城区生活/开封电视台城区生活频道/开封电视台城区生活
襄阳生活频道	hbxytv2	襄阳生活频道/襄阳生活/襄阳电视台生活频道/襄阳电视台生活/襄阳经济频道/襄阳经济/襄阳经济生活频道/襄阳经济生活/襄樊二套/襄樊二/襄樊2套/襄樊2/襄阳二套/襄阳二/襄樊二台/襄阳二台
襄阳文教频道	hbxytv3	襄阳文教频道/襄阳文教/襄阳电视台文教频道/襄阳电视台文教/襄阳文化教育频道/襄阳文化教育/襄樊三套/襄樊三/襄樊3套/襄樊3/襄阳三套/襄阳三/襄樊三台/襄阳三台
南京生活频道	njtv4	南京生活频道/南京生活/南京电视台生活频道/南京电视台生活/江苏南京生活频道/江苏南京生活/南京台生活频道/南京台生活/南京三套/南京三/南京3套/南京3/南京生活台/南京三台
南京十八频道	njtv6	南京十八频道/南京十八/南京电视台十八频道/南京电视台十八/南京18频道/南京18/南京电视台18频道/南京电视台18/南京台18频道/南京台18
南京信息频道	njtv8	南京信息频道/南京信息/南京电视台信息频道/南京电视台信息/南京电视信息频道/南京电视信息/南京台信息频道/南京台信息
溧阳新闻频道	liyangxw	溧阳新闻频道/溧阳新闻
江西少儿家庭频道	jxtv6	江西少儿家庭频道/江西少儿家庭/江西电视台少儿家庭频道/江西电视台少儿家庭/jxtv少儿家庭频道/jxtv少儿家庭/江西6套/江西6/江西台少儿家庭频道/江西台少儿家庭/jxtv6/江西炫彩tv6频道/江西炫彩tv6/江西电视台炫彩频道/江西电视台炫彩/江西炫彩频道/江西炫彩/江西六台/江西六/江西少儿家庭台/江西炫彩台
吉视生活频道	jilin3	吉视生活频道/吉视生活/吉林电视台生活频道/吉林电视台生活/吉林生活电视台/吉林生活电视/吉林生活频道/吉林生活/吉视文体/吉林三套/吉林三/吉林3套/吉林3/吉林3台/吉林三台/吉林生活台
吉视公共新闻	jilin6	吉视公共·新闻/吉林电视台公共·新闻频道/吉林电视台公共·新闻/吉林公共电视台/吉林公共电视/吉林公共频道/吉林公共/吉视公共新闻/吉林电视台公共频道/吉林电视台公共/吉林电视台公共新闻频道/吉林电视台公共新闻/吉视公共频道/吉视公共/吉视公共新闻频道/吉林公共台
长春五套	ctv5	长春五套/长春五/长春电视台五套/长春电视台五/长春电视台ctv5/长春电视台新知频道/长春电视台新知/长视五套/长视五/长春5套/长春5/长春五台/长春5台/长春新知频道/长春新知/长春汽车频道/长春汽车/长春新知台/长春汽车台
辽宁都市频道	lntv2	辽宁都市频道/辽宁都市/辽宁电视台都市频道/辽宁电视台都市/辽宁2台/辽宁2/辽宁都市电视台/辽宁都市电视/辽宁都市台/辽宁综合/辽宁新闻综合台/辽宁新闻综合/辽宁都视
辽宁宜佳频道	lntv4	辽宁宜佳频道/辽宁宜佳/辽宁电视台宜佳购物频道/辽宁电视台宜佳购物/辽宁电视宜佳购物频道/辽宁电视宜佳购物/辽宁台宜佳购物频道/辽宁台宜佳购物/辽宁购物频道/辽宁购物/宜佳购物/辽宁5
高清导视频道	dlgqds	高清导视频道/高清导视/天途高清导视频道/天途高清导视/导视频道高清
乐天购物频道	dlltgw	乐天购物频道/乐天购物/大连电视台乐天购物频道/大连电视台乐天购物/大连8
内蒙蒙语卫视	nmgtv7	内蒙蒙语卫视/内蒙古电视台蒙语卫视频道/内蒙古电视台蒙语卫视/内蒙古电视台蒙古语卫视频道/内蒙古电视台蒙古语卫视/内蒙古蒙古语卫视频道/内蒙古蒙古语卫视/内蒙古蒙语电视台/内蒙古蒙语电视/内蒙古蒙语台/内蒙古蒙语/蒙语卫视/内蒙古蒙语卫视/内蒙古卫视蒙语/内蒙蒙语
蒙古语文化频道	nmgwh	蒙古语文化频道/蒙古语文化/内蒙古电视台蒙古语文化频道/内蒙古电视台蒙古语文化/内蒙古电视台蒙语文化频道/内蒙古电视台蒙语文化/内蒙古文化频道/内蒙古文化
宁夏台公共频道	nxtv1	宁夏台公共频道/宁夏台公共/宁夏电视台公共频道/宁夏电视台公共/宁夏公共频道/宁夏公共/宁夏公共台
宁夏台影视频道	nxtv4	宁夏台影视频道/宁夏台影视/宁夏电视台影视频道/宁夏电视台影视/宁夏影视频道/宁夏影视/宁夏影视台
宁夏精品点播回放	nxtv7	宁夏精品点播回放/宁夏电视台精品点播回放
太原文体频道	sxtytv5	太原文体频道/太原文体/山西太原电视台文体频道/山西太原电视台文体/太原电视台文体频道/太原电视台文体/山西太原台文体频道/山西太原台文体/太原5/太原五台/太原五
潍坊科教频道	sdwf4	潍坊科教频道/潍坊科教/潍坊电视台科教频道/潍坊电视台科教/sdwf4科教频道/sdwf4科教/潍坊四套/潍坊四/潍坊4套/潍坊4/潍坊四台
日照新闻频道	rizhao1	日照新闻频道/日照新闻/日照电视台新闻综合频道/日照电视台新闻综合/日照综合频道/日照综合/日照新闻综合频道/日照新闻综合
上视新闻频道	shhai1	上视新闻频道/上视新闻/上海电视台新闻频道/上海电视台新闻/上海台新闻频道/上海台新闻/上海新闻电视台/上海新闻电视/上海新闻综合频道/上海新闻综合/上视电视台新闻频道/上视电视台新闻/上视电视台新闻综合频道/上视电视台新闻综合/上视新闻综合/上海新闻频道/上海新闻
上视娱乐频道	shhai7	上视娱乐频道/上视娱乐/上海电视台娱乐频道/上海电视台娱乐/上海台娱乐频道/上海台娱乐/上海娱乐频道/上海娱乐/上海娱乐台/上视电视台娱乐频道/上视电视台娱乐/东视新闻娱乐/新闻娱乐频道/新闻娱乐
上视外语频道	shhai9	上视外语频道/上视外语/上海电视台外语频道/上海电视台外语/上海台外语频道/上海台外语/上海台外语频道时间/上海外语电视台/上海外语电视/上视台外语频道/上视台外语/上视外语频道ics
东方购物频道	shhai10	东方购物频道/东方购物/上海电视台东方购物频道/上海电视台东方购物/上海东方购物频道/上海东方购物/cj家庭购物/东方购物1
动漫秀场	sitv1	动漫秀场/新视觉贝贝/新视觉hd贝贝/sitv新视觉少儿/新视觉少儿
动作影院	sitv21	动作影院/iptv动作影院/bestv动作影院
英语教室	sitv22	英语教室
外汇理财	iptvefel	外汇理财/iptv外汇理财频道/iptv外汇理财
XJTV7	xjtv7	xjtv7/新疆电视台汉语经济生活频道/新疆电视台汉语经济生活/新疆电视台第七频道汉语经济生活频道/新疆电视台第七频道汉语经济生活/新疆电视台七频道/新疆电视台七/新疆电视台七套汉语经济生活频道/新疆电视台七套汉语经济生活/新疆汉语经济生活频道/新疆汉语经济生活/新疆台7频道/新疆台7/新疆7频道/新疆7
XJTV10	xjtv10	xjtv10/新疆电视台体育健康频道/新疆电视台体育健康/新疆电视台第十频道体育健康频道/新疆电视台第十频道体育健康/新疆电视台十频道/新疆电视台十/新疆电视台十套体育健康频道/新疆电视台十套体育健康/新疆台10频道/新疆台10/新疆体育健康频道/新疆体育健康/新疆体育频道/新疆体育/新疆十台/新疆十
浙江民生休闲	zjtv6	浙江民生休闲/浙江电视台民生休闲频道/浙江电视台民生休闲/浙江民生频道/浙江民生/ztv民生休闲/ztv6/浙江6频道/浙江6/浙江民生台
湖州公共民生	huzhoutv3	湖州公共民生/湖州电视台公共频道/湖州电视台公共/湖州台公共民生频道/湖州台公共民生/湖州民生频道/湖州民生/湖州公共频道/湖州公共
金华教育科技	jinhuatv2	金华教育科技/金华电视台教育科技频道/金华电视台教育科技/金华台教育科技频道/金华台教育科技/金华教育频道/金华教育
银川台文体频道	yinchuang1	银川台文体频道/银川台文体/银川电视台文体频道/银川电视台文体/银川文体频道/银川文体/银川文体台
环翠一台	whhctv	环翠一台/环翠一/环翠1
烟台电视剧	yantai3	烟台电视剧/烟台电视台电视剧频道/烟台电视台电视剧/烟台3台/烟台3/烟台3套/烟台电视剧频道/烟台三套/烟台三/烟台电视台三套电视剧频道/烟台电视台三套电视剧/yttv3/ytv3/烟台电视剧台/烟台三台
西安新闻综合频道	xian1	西安新闻综合频道/西安新闻综合/西安电视台新闻综合频道/西安电视台新闻综合/西安1台/西安1/西安1套/西安一套/西安一/西安一套新闻频道/西安一套新闻/西安一台/西安新闻频道/西安新闻/xatv1
考试在线	bamc2	考试在线
人物频道	renwu	人物频道/人物/数字电视人物频道/数字电视人物/安徽人物频道/安徽人物
孝感新闻频道	xiaogan3	孝感新闻频道/孝感新闻/孝感电视台新闻频道/孝感电视台新闻/孝感新闻台/孝感综合
中国新华电视	cnc	中国新华电视/cnc电视台/cnc电视/新华社国际电视台/新华社国际电视/cnc新华社电视台/cnc新华社电视/新华社电视台/新华社电视/cnc环球台/cnc环球/cnc新华现场/cnc中文台/cnc中文/新华视讯频道/新华视讯/中國新華電視中文台/中國新華電視中文
智趣频道	zhiqu	智趣频道/智趣
岭南戏曲	lnxq	岭南戏曲/广东电视台岭南戏曲频道/广东电视台岭南戏曲/岭南戏曲频道/广东岭南戏曲频道/广东岭南戏曲
安庆综合频道	aqxw	安庆综合频道/安庆综合/安庆电视台新闻综合频道/安庆电视台新闻综合/安庆新闻频道/安庆新闻
安庆黄梅戏频道	aqhm	安庆黄梅戏频道/安庆黄梅戏/安庆电视台黄梅戏频道/安庆电视台黄梅戏/黄梅戏教育频道/黄梅戏教育/黄梅戏教育台
舟山新闻综合频道	zjzs_zh	舟山新闻综合频道/舟山新闻综合/舟山电视台新闻综合频道/舟山电视台新闻综合/舟山综合频道/舟山综合/舟山台新闻频道/舟山台新闻/舟山综合台/舟山新闻频道/舟山新闻
舟山就业服务台	zjzs_movie	舟山就业服务台/舟山就业服务/舟山电视台就业服务频道/舟山电视台就业服务/舟山就业服务频道
高清综合频道	szthm_sports	高清综合频道/高清综合/天天高清综合/高清体育频道/高清体育/天华高清综合/天华综合/天天高清体育/nvod综合/天华高清体育/华尚高清综艺/dv高清时尚/天华高清时尚/天天风尚频道/天天风尚/综合频道高清
高清综合频道地区	szthm_sports2	高清综合频道地区/综合频道地区高清
MTV	mtv_cn	mtv/mtv音乐频道/mtv音乐/mtv综合电视台/mtv综合电视/mtv 综合电视台/mtv 综合电视/mtv音乐台/mtvchina/mtv音乐电视/סדרות mtv/香港mtv/综合电视台/综合电视
亚洲影院	hsyzyy	亚洲影院/华数亚洲影院/亚洲影视/华语电影
HBO	hbo_cn	hbo/hbo频道/hbo电视台/hbo电视/hbo电影台/hbo电影
天映电影	celetv1_hk	天映电影/天映电影频道/天映频道卫视/天映频道卫星/天映频道卫星电视/天映频道/天映/celestial movies
CNBC亚太财经	cnbc_asia	cnbc亚太财经/cnbc亚洲频道/cnbc亚洲/cnbc asia channel/cnbc asia/cnbc经济台/cnbc经济/亚太财经
高清电视剧频道	gqdsjnvod	高清电视剧频道/高清电视剧/nvod高清电视剧/nvod 高清电视剧/电视剧频道高清
高清纪实频道	hdjishi	高清纪实频道/高清纪实/nvod高清纪实/nvod 高清纪实/天途高清纪实/纪实频道高清
星元亚洲剧场	xyyzjc	星元亚洲剧场
星元亚洲院线	xyyzyx	星元亚洲院线/星元亚洲影视
大众影院频道	dazhongyy	大众影院频道/大众影院/银晟影院/大众电影频道/大众电影
徐州经济生活	xztv2	徐州经济生活/徐州电视台经济生活/徐州·2
IPTV谍战剧场	iptvdzjc	iptv谍战剧场/iptv谍战
IPTV法治	iptvfz	iptv法治
赛事精选2	ssjx2	赛事精选2
呼和浩特新闻综合	hhhttv1	呼和浩特新闻综合/呼和浩特电视台新闻综合频道/呼和浩特电视台新闻综合/呼和浩特1/呼和浩特电视台新闻频道/呼和浩特电视台新闻/呼和浩特一台/呼和浩特一
德阳新闻综合频道	scdytv1	德阳新闻综合频道/德阳新闻综合/德阳电视台新闻综合频道/德阳电视台新闻综合/德阳一套/德阳一/德阳新闻/德阳综合/德阳一台
宁德新闻综合频道	fjndtv1	宁德新闻综合频道/宁德新闻综合/宁德电视台新闻综合频道/宁德电视台新闻综合/宁德1
大同三套	datongtv3	大同三套/大同三/大同电视台生活频道/大同电视台生活/大同生活台/大同生活
鞍山图文频道	ahshantuwen	鞍山图文频道/鞍山图文/鞍山电视台图文频道/鞍山电视台图文
晋中经济生活	xsjztv2	晋中经济生活/晋中电视台经济生活频道/晋中电视台经济生活/晋中二套/晋中二/晋中2/晋中二台
泰州一套	tztv1	泰州一套/泰州一/泰州电视台新闻综合频道/泰州电视台新闻综合/泰州新闻综合
泰州二套	tztv2	泰州二套/泰州二/泰州电视台经济生活频道/泰州电视台经济生活/泰州经济生活
泰州图文频道	tztv4	泰州图文频道/泰州图文/泰州电视台图文频道/泰州电视台图文/泰州图文台
聊城公共频道	lctv2	聊城公共频道/聊城公共/聊城电视台公共服务频道/聊城电视台公共服务/lctv2/聊城公共台
聊城商务频道	lctv3	聊城商务频道/聊城商务/聊城电视台商务频道/聊城电视台商务/lctv3/聊城影视频道/聊城影视/聊城经济频道/聊城经济/聊城生活频道/聊城生活/聊城生活台
廊坊电视台三套	lftv3	廊坊电视台三套/廊坊电视台三/廊坊电视台影视娱乐频道/廊坊电视台影视娱乐/廊坊都市频道/廊坊都市
焦作新闻综合频道	hnjztv1	焦作新闻综合频道/焦作新闻综合/焦作电视台新闻综合频道/焦作电视台新闻综合/焦作电视台一套/焦作电视台一/焦作一套/焦作一/焦作综合/焦作一台
齐齐哈尔经济	qqhrtv4	齐齐哈尔经济/齐齐哈尔电视台经济频道/齐齐哈尔电视台经济/齐齐哈尔科学教育频道/齐齐哈尔科学教育/齐齐哈尔4/齐齐哈尔科学教育台/齐齐哈尔四台/齐齐哈尔四
镇江新闻频道	zhenjiangtv1	镇江新闻频道/镇江新闻/镇江电视台新闻频道/镇江电视台新闻/镇江一套/镇江一/镇江一台
遵义公共频道	gzzytv3	遵义公共频道/遵义公共/遵义电视台公共频道/遵义电视台公共/遵义公共台
马鞍山公共频道	maanshantv2	马鞍山公共频道/马鞍山公共/马鞍山电视台公共频道/马鞍山电视台公共/马鞍山经济频道/马鞍山经济/马鞍山经济生活频道/马鞍山经济生活/马鞍山电视台经济生活频道/马鞍山电视台经济生活
株洲公共频道	hnzztv2	株洲公共频道/株洲公共/株洲电视台公共民生频道/株洲电视台公共民生/株洲公共民生频道/株洲公共民生/株洲公共民生台
临沂新闻综合频道	linyitv1	临沂新闻综合频道/临沂新闻综合/临沂电视台新闻综合频道/临沂电视台新闻综合/临沂综合频道/临沂综合/临沂综合台
荆门公共频道	hbjmtv4	荆门公共频道/荆门公共/荆门电视台公共旅游频道/荆门电视台公共旅游/荆门电视台公共频道/荆门电视台公共/荆门电视台公共台
滨州新闻频道	binzhoutv1	滨州新闻频道/滨州新闻/滨州电视台新闻综合频道/滨州电视台新闻综合/滨州新闻综合/滨州电视台娱乐
北海公共频道	bhtv3	北海公共频道/北海公共/北海电视台公共频道/北海电视台公共
赤峰影视频道	chifengys	赤峰影视频道/赤峰影视/赤峰电视台影视频道/赤峰电视台影视/赤峰影视台
东营综合频道	dytvca1	东营综合频道/东营综合/东营电视台新闻综合频道/东营电视台新闻综合/东营电视台一套/东营电视台一/东营1/东营一台/东营一
莱芜三套	ltv3	莱芜三套/莱芜三/莱芜电视台三套/莱芜电视台三/莱芜公共
东方卫视海外版	dragontv	东方卫视海外版/东方卫视海外频道/东方卫视海外/dragon tv
朝阳新闻综合频道	chytv3	朝阳新闻综合频道/朝阳新闻综合/朝阳电视台新闻综合频道/朝阳电视台新闻综合/朝阳综合频道/朝阳综合/朝阳综合台
NEWTV金牌综艺	jpzongyi	newtv金牌综艺
鄂尔多斯蒙语综合	eedstv2	鄂尔多斯蒙语综合/鄂尔多斯电视台蒙语综合频道/鄂尔多斯电视台蒙语综合/鄂尔多斯4/鄂尔多斯四台/鄂尔多斯四
凉山新闻频道	liangstv1	凉山新闻频道/凉山新闻/凉山电视台新闻综合频道/凉山电视台新闻综合/凉山台/凉山
眉山公共频道	mstv3	眉山公共频道/眉山公共/眉山电视台公共频道/眉山电视台公共/眉山三台/眉山三
东海综合频道	dhzh	东海综合频道/东海综合/东海电视台新闻综合频道/东海电视台新闻综合
衢州经济信息	qztv_3	衢州经济信息/衢州电视台经济信息频道/衢州电视台经济信息/衢州电视台三套/衢州电视台三/衢州电视台三套经济频/衢州三台/衢州三/衢州经济台/衢州经济/衢州经济频道
HBO温馨家庭	hbo_family	hbo温馨家庭/hbo family频道/hbo family/hbo 温馨家庭/hbo family 溫馨家庭/hbo家庭/hbo家庭影院/美国hbo家庭影院/溫馨家庭
新闻调查	xinwendc	新闻调查
情感影院	qingganyy	情感影院/iptv情感影院
河源综合频道	hyrtv_1	河源综合频道/河源综合/河源电视台综合频道/河源电视台综合/河源台/河源/河源综合台
长治公共频道	cztvca2	长治公共频道/长治公共/长治电视台公共频道/长治电视台公共/长治tv2/长治二台/长治二/长治公共台
诸暨新闻频道	zhujitv1	诸暨新闻频道/诸暨新闻/诸暨电视台新闻频道/诸暨电视台新闻/诸暨新闻台
诸暨娱乐频道	zhujitv2	诸暨娱乐频道/诸暨娱乐/诸暨电视台娱乐频道/诸暨电视台娱乐/诸暨娱乐台
绍兴县轻纺城	shaoxtv1	绍兴县轻纺城/绍兴县中国轻纺城频道/绍兴县中国轻纺城/绍兴县轻纺城台
西双版纳一套	xsbntv1	西双版纳一套/西双版纳一/西双版纳电视台一套/西双版纳电视台一/西双版纳一台
西双版纳二套	xsbntv2	西双版纳二套/西双版纳二/西双版纳电视台二套/西双版纳电视台二/西双版纳二台
遂宁互动频道	uiningtv3	遂宁互动频道/遂宁互动/遂宁电视台互动频道/遂宁电视台互动/遂宁互动台
江阴电视剧频道	jsjytv4	江阴电视剧频道/江阴电视剧/江阴电视台电视剧频道/江阴电视台电视剧
NHK BS1	nhk_bs1	nhk bs1/nhkbs1/日本nhk1
安徽国际频道	ahtv8	安徽国际频道/安徽国际/安徽电视台国际频道/安徽电视台国际
安徽导视频道	ahds	安徽导视频道/安徽导视
BTV国际美洲	btvgjmz	btv国际美洲
福建公共频道	fjtv3	福建公共频道/福建公共/福建电视台公共频道/福建电视台公共/福建tv3频道/福建tv3/福建电视公共频道/福建电视公共/福建台公共频道/福建台公共/福建公共台/fjtv3/福建3公共
福建体育频道	fjtv8	福建体育频道/福建体育/福建电视台体育频道/福建电视台体育/福建tv8/福建tv8频道/福建台体育频道/福建台体育/福建体育台/fjtv8/福建8体育/福建青运频道/福建青运
气象影视	qxyingshi	气象影视
福州新闻频道	fztv1	福州新闻频道/福州新闻/福州电视台新闻综合频道/福州电视台新闻综合/福州电视台1套/福州电视台1/福州电视台一套/福州电视台一/福州电视新闻频道/福州电视新闻/福州新闻综合/福州综合频道/福州综合/fztv1/福建福州新闻频道/福建福州新闻/福州电视台一台
厦门纪实频道	xmtv2	厦门纪实频道/厦门纪实/厦门电视台纪实频道/厦门电视台纪实/厦门电视纪实频道/厦门电视纪实/厦门二套/厦门二/厦门2套/厦门2/厦门海峡频道/厦门海峡/福建厦门纪实频道/福建厦门纪实/xmtv2/厦门二台
泉州闽南语频道	qztv4	泉州闽南语频道/泉州闽南语/泉州电视台闽南语频道/泉州电视台闽南语/泉州4套/泉州4/泉州电视闽南语频道/泉州电视闽南语/泉州电视台4/泉州电视台4套/泉州闽南语电视台/泉州闽南语电视/闽南语频道/闽南语/qztv4/泉州四台/泉州四
珠江频道海外版	gdtv5	珠江频道海外版/广东电视台珠江频道海外版/gdtv珠江频道海外版/广东电视珠江频道海外版/广东台珠江频道海外版
广东新闻频道	gdtv6	广东新闻频道/广东新闻/广东电视台新闻频道/广东电视台新闻/广东台新闻台/广东台新闻/gdtv5
深圳移动电视频道	sztv9	深圳移动电视频道/深圳移动电视/深圳电视台移动电视频道/深圳电视台移动电视/深圳电视频道/深圳电视/移动电视/深圳电视台/深圳tv
深圳国际频道美洲	sztv12	深圳国际频道美洲
江门公共频道	jmtv1	江门公共频道/江门公共/江门电视台公共频道/江门电视台公共/广东江门电视台/广东江门电视/江门有线电视台/江门有线电视
TVS2南方卫视	nanfang6	tvs2南方卫视
贵视新闻综合频道	gytv1	贵视新闻综合频道/贵视新闻综合/贵阳电视台新闻综合频道/贵阳电视台新闻综合/贵视台新闻综合频道/贵视台新闻综合/gytv1/贵阳1/贵阳一台/贵阳一
贵视都市频道	gytv4	贵视都市频道/贵视都市/贵阳电视台都市频道/贵阳电视台都市/贵视台都市频道/贵视台都市/gytv4/贵阳4/贵阳都市频道/贵阳都市/贵阳四台/贵阳四
贵视旅游生活频道	gytv5	贵视旅游生活频道/贵视旅游生活/贵阳电视台旅游生活频道/贵阳电视台旅游生活/贵视台旅游生活频道/贵视台旅游生活/贵阳5/贵阳旅游生活频道/贵阳旅游生活/贵阳五台/贵阳五
安顺影视台	anshun2	安顺影视台/安顺影视/安顺电视台影视频道/安顺电视台影视
开封公共频道	kftv3	开封公共频道/开封公共/开封电视台公共频道/开封电视台公共
湖北经济频道	hubei8	湖北经济频道/湖北经济/湖北电视台经视频道/湖北电视台经视/湖北经济电视台/湖北经济电视/湖北经济台/湖北经视/湖北电视台经济频道/湖北电视台经济
江苏公共新闻	jstv8	江苏公共新闻
江苏教育电视台	jstv9	江苏教育电视台/江苏教育电视/江苏电视教育频道/江苏电视教育/江苏教育频道/江苏教育/江苏教育电视台频道/江苏教育台
苏州数字导视	szszds	苏州数字导视
吉视综艺文化	jilin7	吉视综艺文化
长春三套	ctv3	长春三套/长春三/长春电视台三套/长春电视台三/长春电视台ctv3/长春电视台市民频道/长春电视台市民/长视三套/长视三/长春市民频道/长春市民/长春3套/长春3/长春三台/长春3台/长春市民台
长影频道	changyingtv	长影频道/长影
辽宁北方频道	lntv8	辽宁北方频道/辽宁北方/辽宁电视台北方频道/辽宁电视台北方/辽宁北方电视台/辽宁北方电视/辽宁北方台/辽视北方频道电视/辽视北方台/辽视北方/北方频道/北方/辽视北方频道
沈阳新闻频道	lnsy1	沈阳新闻频道/沈阳新闻/沈阳电视台新闻频道/沈阳电视台新闻/sytv新闻频道/sytv新闻/沈阳电视台1/沈阳新闻台/sytv1/沈阳一台/沈阳一/沈阳1套/沈阳1/沈阳一套/沈阳1台/沈阳1频道/沈视1套/沈视1
大连新闻综合频道	dalian1	大连新闻综合频道/大连新闻综合/大连电视台新闻综合频道/大连电视台新闻综合/dltv1/dltv新闻综合频道/dltv新闻综合/大连1台/大连1/大连电视台1/大连新闻台/大连新闻/大连新闻频道/大连一台/大连一/大连一套/大连1套
铁岭快乐三频道	tieling3	铁岭快乐三频道/铁岭快乐三/铁岭电视台快乐三频道/铁岭电视台快乐三/铁视3套/铁视3/铁岭三台/铁岭三/铁岭3台/铁岭3/铁岭公共/铁岭公共频道/铁岭三套/铁岭电视台公共频道/铁岭电视台公共/铁视三套/铁视三/铁岭快乐3
山西科教频道	sxtv4	山西科教频道/山西科教/山西电视台科教频道/山西电视台科教/山西台科教频道/山西台科教
DMC电视剧频道	dmcdrama	dmc电视剧频道/dmc电视剧/山西电视剧轮播/dmc轮播电视剧频道/dmc轮播电视剧
太原新闻频道	sxtytv1	太原新闻频道/太原新闻/山西太原电视台新闻频道/山西太原电视台新闻/太原电视台新闻频道/太原电视台新闻/太原电视台一套新闻频道/太原电视台一套新闻/tytv1/太原1/太原电视台一台/太原电视台一
太原法制频道	sxtytv3	太原法制频道/太原法制/山西太原电视台法制频道/山西太原电视台法制/太原电视台法制频道/太原电视台法制/太原台法制频道/太原台法制/太原3/太原三台/太原三
济南新闻综合	jntv1	济南新闻综合/济南电视台新闻综合频道/济南电视台新闻综合/jntv1新闻综合频道/jntv1新闻综合/济南新闻综合频道/jntv1/济南新闻频道/济南新闻
济南都市频道	jntv2	济南都市频道/济南都市/济南电视台都市频道/济南电视台都市/jntv2都市频道/jntv2都市/济南女性频道/济南女性/jntv2/济南都市台/济南女性台
济南影视频道	jntv3	济南影视频道/济南影视/济南电视台影视频道/济南电视台影视/jntv3影视频道/jntv3影视/济南影视台/jntv3
济南商务频道	jntv6	济南商务频道/济南商务/济南电视台商务频道/济南电视台商务/jntv6商务频道/jntv6商务/jntv6/济南商务台
泰安新闻	tatv1	泰安新闻/泰安电视台新闻综合频道/泰安电视台新闻综合/泰安电视台一频道/泰安电视台一/泰安一套/泰安一/tatv1/泰安1套/泰安1/泰安台一套/泰安台一/泰安新闻综合频道/泰安新闻综合/泰安新闻台/泰安一台
艺术人文频道	shhai8	艺术人文频道/艺术人文/上海电视台艺术人文频道/上海电视台艺术人文/上海台艺术人文频道/上海台艺术人文/上海文艺台/上海文艺/上海艺术人文电视台/上海艺术人文电视/上海艺术人文/东视艺术人文/上视艺术人文频道/上视艺术人文/上海艺术人文频道
都市剧场	sitv12	都市剧场/新视觉hd电影/新视觉电影
东方财经浦东	sitv14	东方财经浦东
SITV经典剧场	sitv15	sitv经典剧场/sitv数字电视sitv经典剧场/上海经典剧场/数字电视sitv经典剧场
玩具益智	sitv26	玩具益智/sitv玩具益智/sitv玩具益智频道/上海玩具益智频道/上海玩具益智/玩具益智频道
幸福彩	sitv29	幸福彩/新视觉旅游/新视觉hd旅游
新视觉高清纪实	sitv_documentary	新视觉高清纪实/新视觉纪实高清
上海新视觉娱乐高清	sitv_yule	上海新视觉娱乐高清
资讯气象	sitv_zxqx	资讯气象
新视觉HD游戏	sitv_game	新视觉hd游戏/新视觉游戏高清
DOX英伦	doxyl	dox英伦/风尚英伦/星元英伦/高清英伦时尚/高清英伦风/影像英伦
四川文化旅游频道	sctv2	四川文化旅游频道/四川文化旅游/四川电视台文化旅游频道/四川电视台文化旅游/sctv2/sctv2文化旅游频道/sctv2文化旅游/四川电视台2套/四川电视台2/四川台文化旅游频道/四川台文化旅游/四川二套/四川二/四川2套/四川2/四川二台/四川2台/四川旅游频道/四川旅游
四川国际频道	scguoji	四川国际频道/四川国际/四川电视台国际频道/四川电视台国际/四川国际台
成都公共频道	chengdu5	成都公共频道/成都公共/成都电视台公共频道/成都电视台公共/cdtv5/成都电视台体育频道/成都电视台体育/cdtv5公共频道/cdtv5公共/cdtv5成都公共频道/cdtv5成都公共/成都体育频道/成都体育/成都五台/成都五/成都公共台
XJTV8	xjtv8	xjtv8/新疆电视台哈语综艺频道/新疆电视台哈语综艺/新疆电视台八频道/新疆电视台八/新疆电视台八套哈语综艺频道/新疆电视台八套哈语综艺/新疆电视台第八频道哈语综艺频道/新疆电视台第八频道哈语综艺/新疆哈语综艺频道/新疆哈语综艺/新疆台8频道/新疆台8/新疆8频道/新疆8/新疆八台/新疆八
杭州影视频道	htv4	杭州影视频道/杭州影视/杭州电视台影视频道/杭州电视台影视/杭州台影视频道/杭州台影视/htv4/杭州四套/杭州四/杭州4套/杭州4/utv杭州影视频道/utv杭州影视/htv4杭州影视/杭州台影视台/杭州四台
宁波都市文体	nbtv3	宁波都市文体/宁波电视台都市文体频道/宁波电视台都市文体/宁波都市文体频道/宁波台都市文体频道/宁波台都市文体/宁波三套/宁波三/宁波3套/宁波3/宁波3台/宁波三台/宁波文化娱乐频道/宁波文化娱乐/nbtv3/宁波都市文体台
温州经济科教	wztv2	温州经济科教/温州电视台经济科教频道/温州电视台经济科教/温州台经济科教频道/温州台经济科教/温州经济科教电视台/温州经济科教电视/温州2台/温州2/温州经济科教台/温州二台/温州二
青海经济生活	qhtv2	青海经济生活/青海电视台经济生活频道/青海电视台经济生活/qhtv1/青海台经济生活频道/青海台经济生活/青海经济生活电视台/青海经济生活电视/青海生活经济频道/青海生活经济
嘉兴新闻综合	jiaxintv1	嘉兴新闻综合/嘉兴电视台新闻综合频道/嘉兴电视台新闻综合/嘉兴台新闻综合频道/嘉兴台新闻综合/嘉兴综合频道/嘉兴综合/嘉兴新闻频道/嘉兴新闻/嘉兴新闻综合台/嘉兴综合台/嘉兴新闻台
嘉兴公共频道	jiaxintv3	嘉兴公共频道/嘉兴公共/嘉兴电视台公共频道/嘉兴电视台公共/嘉兴台都市生活频道/嘉兴台都市生活/嘉兴公共城市频道/嘉兴公共城市/嘉兴公共城市台
金华经济生活	jinhuatv3	金华经济生活/金华电视台经济生活频道/金华电视台经济生活/金华台经济生活频道/金华台经济生活
牡丹江新闻综合频道	moudanjian1	牡丹江新闻综合频道/牡丹江新闻综合/牡丹江电视台新闻综合频道/牡丹江电视台新闻综合/牡丹江台新闻综合频道/牡丹江台新闻综合/牡丹江新闻频道/牡丹江新闻/牡丹江综合频道/牡丹江综合/牡丹江新闻综合台
牡丹江地产频道	moudanjian5	牡丹江地产频道/牡丹江地产/牡丹江电视台地产频道/牡丹江电视台地产
义乌新闻频道	zjyiwu1	义乌新闻频道/义乌新闻/义乌电视台新闻频道/义乌电视台新闻/义乌台新闻频道/义乌台新闻/义乌新闻综合/义乌新闻台
延边卫视	yanbian1	延边卫视/吉林朝语频道/吉林朝语/朝鲜语频道/朝鲜语/延边台/延边电视台/延边tv/延边电视
烟台新闻综合	yantai1	烟台新闻综合/烟台电视台新闻综合频道/烟台电视台新闻综合/烟台1台/烟台1/烟台1套/烟台新闻综合频道/烟台一套/烟台一/yttv1/烟台新闻频道/烟台新闻/烟台综合频道/烟台综合/ytv1/烟台新闻综合台/烟台一台/烟台新闻台/烟台综合台
西安文化影视频道	xian4	西安文化影视频道/西安文化影视/西安电视台文化影视频道/西安电视台文化影视/西安4台/西安4/西安4套/西安四套/西安四/西安影视频道/西安影视/西安四台/西安文化频道/西安文化/xatv4
CHC家庭影院	chc2	chc家庭影院/chc家庭影院频道/华诚影院/华诚家庭影院/chc影院/chc家庭电影
南昌精品房产	ncjpfc	南昌精品房产
南昌新闻综合频道	nanchang1	南昌新闻综合频道/南昌新闻综合/南昌电视台新闻综合频道/南昌电视台新闻综合/南昌新闻频道/南昌新闻/南昌综合频道/南昌综合/南昌新闻台/南昌1/nctv1/南昌电视台一套/南昌电视台一/南昌电视台1/南昌一台/南昌一/南昌综合台
南昌资讯频道	nanchang3	南昌资讯频道/南昌资讯/南昌电视台资讯频道/南昌电视台资讯/南昌资讯台/南昌3/nctv3/南昌法制频道/南昌法制/南昌电视台资讯政法频道/南昌电视台资讯政法/南昌电视台3/南昌三台/南昌三
南昌都市频道	nanchang4	南昌都市频道/南昌都市/南昌电视台都市频道/南昌电视台都市/南昌电视台二套都市频道/南昌电视台二套都市/南昌2套/南昌2/南昌电视台2都市频道/南昌电视台2都市/nctv2/南昌电视台二套/南昌电视台二/南昌电视台2/南昌二台/南昌二/南昌都市台
新华社英语台	cnc_world	新华社英语台/新华社英语/新华社英语电视台/新华社英语电视/cnc英语电视台/cnc英语电视/新华社英语频道/新华社英文电视台/新华社英文电视/cnc world/cnc英语台/cnc英语/cnc英文台/cnc英文/中國新華電視英文台/中國新華電視英文
兵团新闻频道	btxw	兵团新闻频道/兵团新闻
北大荒农业频道	bdhny	北大荒农业频道/北大荒农业/北大荒电视台农业频道/北大荒电视台农业/北大荒农业台/北大荒农业电视台/北大荒农业电视/黑龙江电视台农业频道/黑龙江电视台农业/黑龙江农业频道/黑龙江农业
高清影视频道地区	szthm_movies2	高清影视频道地区/影视频道地区高清
明珠台	tvb2	明珠台/明珠/tvb pearl/pearl/tvb明珠台/tvb明珠/香港明珠/无线明珠
DISCOVERY	discovery	discovery/discovery探索频道/discovery探索/美国探索频道/美国探索/探索频道/探索/discovery 頻道/discovey channel
彭博财经台	bloomberg_tv_tw	彭博财经台/彭博财经/彭博电视台/彭博电视/bloomberg/彭博资讯/彭博财经频道/bloomberg television/bloomberg television 彭博財經台/bloomberg television 彭博財經/bloomberg彭博
法国TV5MONDE	tv5monde_asie	法国tv5monde/法国第五台/法国第五/tv5monde/法国tv5电视台/法国tv5电视/tv 5 monde/tv5 france/tv5 monde/tv5monde法语/tv5法语电视台/tv5法语电视/法語電視台/法語電視/tv5monde 法國電視台/tv5monde 法國電視/tv5 monde europe/tv5 monde 法語電視台/tv5 monde 法語電視/法国tv5/法国电视五台/法国电视五
运城科教频道	yctv3	运城科教频道/运城科教/运城电视台三套/运城电视台三/运城3套/运城3/运城电视台3套/运城电视台3/运城三套/运城三/运城三台
星元川网导视	xycwds	星元川网导视/川网导视/四川导视
IPTV少儿动画	iptvsedh	iptv少儿动画
吴江新闻综合频道	wjtv1	吴江新闻综合频道/吴江新闻综合/吴江电视台新闻综合频道/吴江电视台新闻综合
星元欧美剧场	xyomjc	星元欧美剧场/星元欧洲剧场
星元欧美院线	xyomyx	星元欧美院线/星元欧洲影视
星元首映	xysy	星元首映
第一导视	dyds	第一导视/江苏导视频道/江苏导视
莱芜二套	ltv2	莱芜二套/莱芜二/莱芜电视台二套/莱芜电视台二/莱芜科教
KNEWS24	kkxw	knews24
赛事精选1	ssjx1	赛事精选1
IPTV演唱会	bstych	iptv演唱会
包头新闻综合频道	bttv_1	包头新闻综合频道/包头新闻综合/包头电视台新闻综合频道/包头电视台新闻综合/包头一套/包头一/包头电视台一套/包头电视台一/包头一台/包头电视台一台
乌海新闻综合频道	wuhaitv1	乌海新闻综合频道/乌海新闻综合
扬州生活频道	yztv3	扬州生活频道/扬州生活/扬州电视台生活频道/扬州电视台生活/扬州三套/扬州三/扬州三台
唐山影视频道	tssv3	唐山影视频道/唐山影视/唐山电视台影视频道/唐山电视台影视/唐山3/唐山文化影视/唐山三台/唐山三
唐山公共频道	tssv4	唐山公共频道/唐山公共/唐山电视台公共频道/唐山电视台公共/唐山4/唐山四台/唐山四
大同一套	datongtv1	大同一套/大同一/大同电视台新闻综合频道/大同电视台新闻综合/大同综合
大同二套	datongtv2	大同二套/大同二/大同电视台影视频道/大同电视台影视/大同影视台/大同影视
大同教育频道	dtedu	大同教育频道/大同教育/大同教育电视台/大同教育电视
鞍山时尚频道	ahshantv4	鞍山时尚频道/鞍山时尚/鞍山电视台时尚频道/鞍山电视台时尚/鞍山时尚台
吉林市电视剧频道	jlctv5	吉林市电视剧频道/吉林市电视剧/吉林市电视台电视剧频道/吉林市电视台电视剧
葫芦岛社会生活	hldtv2	葫芦岛社会生活/葫芦岛电视台社会生活频道/葫芦岛电视台社会生活/葫芦岛二套/葫芦岛二/葫芦岛2/葫芦岛二台
鹤岗公共频道	hgtv2	鹤岗公共频道/鹤岗公共/鹤岗电视台公共频道/鹤岗电视台公共/鹤岗公共台
矿区新闻综合	hgtv3	矿区新闻综合/鹤岗电视台矿区新闻综合频道/鹤岗电视台矿区新闻综合
盱眙综合频道	xuyixwzh	盱眙综合频道/盱眙综合/盱眙县新闻综合频道/盱眙县新闻综合
南通数字电视宣传	nttv4	南通数字电视宣传/南通数字电视宣传频道
桂林新闻综合频道	glxw	桂林新闻综合频道/桂林新闻综合/桂林电视台新闻综合频道/桂林电视台新闻综合/桂林新闻综合台
桂林公共频道	glgg	桂林公共频道/桂林公共/桂林电视台公共频道/桂林电视台公共/桂林公共台
睛彩广西交通	jcgxjt	睛彩广西交通/睛彩广西交通频道/睛彩广西频道/睛彩广西
如皋经济生活	rgjjsh	如皋经济生活/如皋电视台经济生活频道/如皋电视台经济生活/如皋经济台/如皋经济
芜湖生活频道	wuhutv2	芜湖生活频道/芜湖生活/芜湖电视台生活频道/芜湖电视台生活/芜湖电视台经济生活频道/芜湖电视台经济生活/芜湖经济生活台/芜湖经济生活
黄山一套	hstv1	黄山一套/黄山一/黄山新闻综合频道/黄山新闻综合/黄山电视台一套/黄山电视台一/黄山一台
南充综合频道	scnctv1	南充综合频道/南充综合/南充电视台综合频道/南充电视台综合/南充新闻频道/南充新闻/南充新闻台
南充文娱频道	scnctv4	南充文娱频道/南充文娱/南充电视台文娱频道/南充电视台文娱/南充文娱台
广元综合频道	scgytv1	广元综合频道/广元综合/广元电视台新闻综合频道/广元电视台新闻综合/广元综合台
梧州新闻综合频道	gxwztv1	梧州新闻综合频道/梧州新闻综合/梧州电视台新闻综合频道/梧州电视台新闻综合
惠州三套	gdhztv3	惠州三套/惠州三/惠州电视台三套/惠州电视台三/惠州三台
梅州时政综合频道	gdmztv1	梅州时政综合频道/梅州时政综合/梅州电视台时政综合频道/梅州电视台时政综合/mztv1/梅州时政综合台
常德新闻频道	hncdtv1	常德新闻频道/常德新闻/常德电视台新闻频道/常德电视台新闻/常德新闻台
济宁影视频道	sdjntv3	济宁影视频道/济宁影视/济宁电视台影视频道/济宁电视台影视/济宁三套/济宁三/济宁电视台三套/济宁电视台三/济宁三台
济宁都市频道	sdjntv4	济宁都市频道/济宁都市/济宁电视台都市频道/济宁电视台都市
十堰新闻频道	hbsytv1	十堰新闻频道/十堰新闻/十堰电视台新闻频道/十堰电视台新闻/十堰新闻台
十堰武当频道	hbsytv4	十堰武当频道/十堰武当/十堰电视台武当频道/十堰电视台武当/十堰信息咨讯
濮阳新闻综合频道	hnpytv1	濮阳新闻综合频道/濮阳新闻综合/濮阳电视台新闻综合频道/濮阳电视台新闻综合/濮阳一套/濮阳一/濮阳1/濮阳一台
濮阳公共频道	hnpytv2	濮阳公共频道/濮阳公共/濮阳电视台公共频道/濮阳电视台公共/濮阳二套/濮阳二/濮阳2/濮阳二台
咸阳影视频道	sxxytv2	咸阳影视频道/咸阳影视/咸阳电视台影视频道/咸阳电视台影视/咸阳二套/咸阳二/咸阳二台
驻马店科学教育	zmdtv2	驻马店科学教育/驻马店电视台科学教育频道/驻马店电视台科学教育/驻马店二套/驻马店二/驻马店科教/驻马店二台
NGC HD	ngc_hd	ngc hd/国家地理高清频道/国家地理高清/国家地理高画质频道/国家地理高画质/national geographic hd/ngc高清
莱芜一套	ltv1	莱芜一套/莱芜一/莱芜电视台一套/莱芜电视台一/莱芜新闻频道/莱芜新闻/莱芜综合
NEWTV军事评论	jspinglun	newtv军事评论
第一电影	dydianying	第一电影
丽水新闻综合频道	lsxw	丽水新闻综合频道/丽水新闻综合/丽水电视台新闻综合频道/丽水电视台新闻综合
随州影视频道	suizhoutv2	随州影视频道/随州影视/随州电视台影视频道/随州电视台影视
临夏公共频道	linxiatv2	临夏公共频道/临夏公共/临夏电视台公共频道/临夏电视台公共
社会纪实	shjs	社会纪实
亳州农村频道	haozhoutv2	亳州农村频道/亳州农村/亳州电视台农村频道/亳州电视台农村
蛇口综合频道	sktv1	蛇口综合频道/蛇口综合/蛇口电视台综合频道/蛇口电视台综合
财经纵横	caijinglt	财经纵横
武威新闻综合频道	wwxwzh	武威新闻综合频道/武威新闻综合/武威电视台新闻综合频道/武威电视台新闻综合/武威新闻综合台
武威凉州频道	wwlz	武威凉州频道/武威凉州/武威电视台凉州频道/武威电视台凉州/武威凉州台
宿迁综合频道	sqxx	宿迁综合频道/宿迁综合/宿迁电视台综合频道/宿迁电视台综合/宿迁综合台
江宁生活频道	jnshuo	江宁生活频道/江宁生活/江宁生活台
塔城三套	tctv3	塔城三套/塔城三/塔城电视台三套/塔城电视台三/塔城综艺频道/塔城综艺/塔城综艺台/塔城三台
长兴快乐2	changxtv2	长兴快乐2/长兴电视台文化生活频道/长兴电视台文化生活/长兴文化台/长兴文化
铜仁公共频道	trtv2	铜仁公共频道/铜仁公共/铜仁电视台公共频道/铜仁电视台公共/铜仁公共台
江阴新闻综合频道	wjytv1x	江阴新闻综合频道/江阴新闻综合/江阴电视台新闻综合频道/江阴电视台新闻综合/江阴新闻综合台
宜昌综合频道	yichangtv1	宜昌综合频道/宜昌综合/宜昌电视台综合频道/宜昌电视台综合/宜昌综合台
淮北公共频道	ahhbtv2	淮北公共频道/淮北公共/淮北电视台公共频道/淮北电视台公共
淮北影视频道	ahhbtv_3	淮北影视频道/淮北影视/淮北电视台影视频道/淮北电视台影视
百色综合频道	bstv1	百色综合频道/百色综合/百色电视台综合频道/百色电视台综合/百色综合台
富阳新闻综合	fyxwzh	富阳新闻综合/富阳电视台新闻综合频道/富阳电视台新闻综合
富阳生活文化	fywhsh	富阳生活文化
沭阳综合频道	shuyangzh	沭阳综合频道/沭阳综合/沭阳电视台综合频道/沭阳电视台综合/沭阳综合台
靖江新闻综合	jingjiangxw	靖江新闻综合/靖江新闻综合频道
邳州新闻综合	pizhouxw	邳州新闻综合/邳州电视台新闻综合频道/邳州电视台新闻综合/邳州新闻综合频道
皖江购物频道	wanjiangshop	皖江购物频道/皖江购物
北京科教频道	btv3	北京科教频道/北京科教/北京电视台科教频道/北京电视台科教/btv3/btv3台/btv3套/btv科教/btv科教频道/btv科教台/北京3台/北京3/北京3套/北京电视台三套/北京电视台三/北京科教台/北京三台/北京三/北京三套/北京台科教频道/北京台科教
重庆生活频道	ccqtv7	重庆生活频道/重庆生活/重庆电视台生活频道/重庆电视台生活/重庆台生活频道/重庆台生活/重庆六套/重庆六/重庆6套/重庆6/cqtv生活/cqtv6/重庆六台
重庆公共农村频道	ccqtv9	重庆公共农村频道/重庆公共农村/重庆电视台公共农村频道/重庆电视台公共农村/cqtv公共/重庆台公共频道/重庆台公共/重庆公共/重庆八套/重庆八/重庆8套/重庆8/cqtv8/重庆公共·农村/重庆公共频道/cqtv公共农村/重庆八台
福州生活频道	fztv3	福州生活频道/福州生活/福州电视台生活频道/福州电视台生活/福州电视生活频道/福州电视生活/福州电视台3套/福州电视台3/福州电视台三套/福州电视台三/福建福州生活频道/福建福州生活/fztv3/福州电视台三台
兰州新闻综合频道	lanzhoutv1	兰州新闻综合频道/兰州新闻综合/兰州电视台新闻综合频道/兰州电视台新闻综合/兰州新闻频道/兰州新闻/兰州综合频道/兰州综合/兰州台新闻综合频道/兰州台新闻综合
兰州生活经济频道	lanzhoutv3	兰州生活经济频道/兰州生活经济/兰州电视台生活经济频道/兰州电视台生活经济/兰州生活经济电视台/兰州生活经济电视/兰州台生活经济频道/兰州台生活经济
深视电视剧频道	sztv3	深视电视剧频道/深视电视剧/深圳电视台电视剧频道/深圳电视台电视剧/深视二套/深视二/深圳2套/深圳2/深圳2套电视剧频道/深圳2套电视剧/深圳电视剧频道/深圳电视剧/深圳二台/深圳二/深圳二套/深圳2台
深圳娱乐频道	sztv5	深圳娱乐频道/深圳娱乐/深圳电视台娱乐频道/深圳电视台娱乐/深视四套/深视四/深圳4套/深圳4/深圳4套娱乐频道/深圳4套娱乐/深圳四台/深圳四/深视娱乐/深视娱乐频道/深圳四套/深圳4台/深视娱乐生活/深视生活频道/深视生活
深圳卫视亚洲	sztv10	深圳卫视亚洲/深圳电视台国际频道/深圳电视台国际/深圳国际
广州少儿频道	gztv7	广州少儿频道/广州少儿/广州电视台少儿频道/广州电视台少儿/广视少儿频道/广视少儿/广州少儿台/gztv7
佛山影视频道	gdfs2	佛山影视频道/佛山影视/佛山电视台影视频道/佛山电视台影视/佛山市影视频道/佛山市影视/广东佛山电视台影视频道/广东佛山电视台影视/佛山电视影视/佛山电视影视频道/佛山影视台/gdfs2
佛山公共频道	gdfs3	佛山公共频道/佛山公共/佛山电视台公共频道/佛山电视台公共/佛山台公共频道/佛山台公共/广东佛山电视台公共频道/广东佛山电视台公共/gdfs3/佛山公共台
中山公共频道	gdzs2	中山公共频道/中山公共/中山电视台公共频道/中山电视台公共/广东中山电视台公共频道/广东中山电视台公共/gdzs2/中山台/中山
潮州台公共频道	czbtv2	潮州台公共频道/潮州台公共/潮州电视台公共频道/潮州电视台公共/广东潮州电视台公共频道/广东潮州电视台公共/czbtv2/潮州公共电视台/潮州公共电视/潮州公共/潮州台/潮州/广东潮州公共频道/广东潮州公共
东莞新闻综合	gddg1	东莞新闻综合/东莞电视台新闻综合频道/东莞电视台新闻综合/广东东莞电视台第一频道/广东东莞电视台第一/东莞第1频道/东莞第1/东莞电视台第一频道/东莞电视台第一/东莞台第一频道/东莞台第一/东莞综合频道/东莞综合
东莞公共频道	gddg2	东莞公共频道/东莞公共/东莞电视台公共频道/东莞电视台公共/东莞2台/东莞2/广东东莞电视台第二频道/广东东莞电视台第二/东莞第2频道/东莞第2/东莞电视台第二频道/东莞电视台第二/东莞台第二频道/东莞台第二
贵州电视剧频道	guizoutv3	贵州电视剧频道/贵州电视剧/贵州电视台三频道/贵州电视台三/贵州电影频道/贵州电影/贵州台电视剧频道/贵州台电视剧/贵州台影视文艺频道/贵州台影视文艺/贵州电视台电视剧频道/贵州电视台电视剧/贵州3频道/贵州3/贵州三台/贵州三
河北农民频道	hebei7	河北农民频道/河北农民/河北电视台农民频道/河北电视台农民/河北台农民频道/河北台农民/hebtv7/河北七套/河北七/河北7套/河北7/河北七台/河北7台/河北农民台
黑龙江手机电视	hljsjtv	黑龙江手机电视/黑龙江电视台手机电视频道/黑龙江电视台手机电视
河南都市频道	hntv2	河南都市频道/河南都市/河南电视台都市频道/河南电视台都市/河南都市频道2/河南2套/河南2/河南二套/河南二/hntv2/hntv2都市/河南电视台2/河南二台
河南公共频道	hntv8	河南公共频道/河南公共/河南电视台公共频道/河南电视台公共/河南公共频道8/河南八套/河南八/河南8套/河南8/河南台公共频道/河南台公共/hntv8/hntv8公共/河南电视台8/河南八台
新乡影视娱乐频道	hnxxtv3	新乡影视娱乐频道/新乡影视娱乐/新乡电视台影视娱乐频道/新乡电视台影视娱乐/新乡影视/新乡影视台
新乡生活频道	hnxxtv4	新乡生活频道/新乡生活/新乡电视台生活频道/新乡电视台生活/新乡生活图文频道/新乡生活图文/新乡生活台
湖北生活频道	hubei5	湖北生活频道/湖北生活/湖北电视台生活频道/湖北电视台生活/湖北省电视台体育频道/湖北省电视台体育/湖北体育台/湖北体育/湖北五套/湖北五/湖北5套/湖北5/湖北台体育频道/湖北台体育/湖北电视体育频道/湖北电视体育/湖北五台/湖北电视体育台
美嘉购物	hubei6	美嘉购物/湖北电视台美嘉购物频道/湖北电视台美嘉购物/湖北省电视台都市频道/湖北省电视台都市/美嘉购物频道/都市美嘉购物频道/都市美嘉购物/湖北美嘉购物频道/湖北美嘉购物
湖北公共新闻	hubei7	湖北公共新闻
武汉电视剧频道	whtv2	武汉电视剧频道/武汉电视剧/武汉电视台电视剧频道/武汉电视台电视剧/武汉2台/武汉2/武汉2套/武汉电视台2套/武汉电视台2/武汉电视台二套/武汉电视台二/武汉电视台文艺/武汉二台/武汉二/武汉二套/武汉文艺/whtv2/武汉文艺频道/武汉文艺台
荆州新闻台	jztv1	荆州新闻台/荆州新闻/荆州电视台新闻频道/荆州电视台新闻/荆州电视台一套/荆州电视台一/荆州新闻频道/荆州一套/荆州一/荆州电视新闻频道/荆州电视新闻/荆州一台
常州图文频道	changzhoutuwen	常州图文频道/常州图文/常州电视台图文频道/常州电视台图文
常州新闻综合频道	changzhou1	常州新闻综合频道/常州新闻综合/常州电视台新闻综合频道/常州电视台新闻综合/常州台新闻综合频道/常州台新闻综合/常州新闻频道/常州新闻/常州新闻电视台/常州新闻电视/常州新闻综合台/常州新闻台
江西都市频道	jxtv2	江西都市频道/江西都市/江西电视台都市频道/江西电视台都市/jxtv都市频道/jxtv都市/江西2套/江西2/江西2台/江西电视台2套/江西电视台2/江西二套/江西二/江西台二套/江西台二/江西卫视2套/江西卫视2/江西卫视2套电视剧/江西卫视二套/江西卫视二/jxtv2/江西二台
江西经视频道	jxtv3	江西经视频道/江西经视/江西电视台经济生活频道/江西电视台经济生活/jxtv经济生活频道/jxtv经济生活/江西3套/江西3/江西3台/江西电视台3套/江西电视台3/江西三套/江西三/江西卫视3套/江西卫视3/江西卫视三套/江西卫视三/jxtv3/江西经济生活频道/江西经济生活/江西三台/江西经济生活台
江西公共频道	jxtv5	江西公共频道/江西公共/江西电视台公共频道/江西电视台公共/jxtv公共频道/jxtv公共/江西5套/江西5/江西5台/江西电视台5套/江西电视台5/江西五套/江西五/江西台五套/江西台五/江西五台/jxtv5/江西公共台
长春一套	ctv1	长春一套/长春一/长春电视台一套/长春电视台一/长春电视台ctv1/长春电视台综合频道/长春电视台综合/长视一套/长视一/长春1套/长春1/长春新闻综合频道/长春新闻综合/长春一台/长春1台/ctv 1/ctv1/长春综合/长春新闻综合台
长春二套	ctv2	长春二套/长春二/长春电视台二套/长春电视台二/长春电视台ctv2/长春电视台娱乐频道/长春电视台娱乐/长视二套/长视二/长春2套/长春2/长春二台/长春2台/长春电视台2套/长春电视台2/长春娱乐
辽宁公共频道	lntv7	辽宁公共频道/辽宁公共/辽宁电视台公共频道/辽宁电视台公共/辽宁公共电视台/辽宁公共电视/辽宁公共台/沈阳公共频道/沈阳公共
辽宁体育频道	lntv_sport	辽宁体育频道/辽宁体育/辽宁电视台体育频道/辽宁电视台体育/辽宁4/辽宁体育台
抚顺公共频道	lnfs2	抚顺公共频道/抚顺公共/抚顺电视台公共频道/抚顺电视台公共/lnfs公共频道/lnfs公共/抚顺公共台/抚顺电视台二套/抚顺电视台二/抚顺二套/抚顺二/抚顺二台/抚顺2套/抚顺2/抚顺2台
内蒙新闻综合频道	nmgtv2	内蒙新闻综合频道/内蒙新闻综合/内蒙古电视台新闻综合频道/内蒙古电视台新闻综合/内蒙古新闻综合电视台/内蒙古新闻综合电视/内能古新闻综合台/内能古新闻综合/内蒙古新闻综合频道/内蒙古新闻综合
宁夏台经济频道	nxtv3	宁夏台经济频道/宁夏台经济/宁夏电视台经济频道/宁夏电视台经济/宁夏经济频道/宁夏经济/宁夏经济台
山西卫视	sxtv1	山西卫视/山西卫视频道/山西卫星电视/山西卫星频道/山西卫星/树叶台/树叶/山西电视台/山西电视/山西台/山西/山西tv
太原六套	sxtytv6	太原六套/太原六/太原电视台六套/太原电视台六/太原6套/太原6/太原6台
山东生活频道	sdtv9	山东生活频道/山东生活/山东电视台生活频道/山东电视台生活/山东电视生活频道/山东电视生活/山东台生活频道/山东台生活/山东生活台/sdtv生活
环球剧场	hqjc	环球剧场/海外电视剧
青岛财经资讯频道	sdqd4	青岛财经资讯频道/青岛财经资讯/青岛电视台财经资讯频道/青岛电视台财经资讯/qtv4财经资讯频道/qtv4财经资讯/青岛4台/青岛4/青岛四套/青岛四/青岛四台/青岛4套/qtv4/青岛台财经资讯频道/青岛台财经资讯/青岛休闲资讯频道/青岛休闲资讯/青岛财经资讯台/青岛休闲资讯台
东方电影台	dfmv1	东方电影台/东方电影/东方电影频道/上海东方电影频道/上海东方电影/上海东方电影台
新视觉HD电影	sitv_movie	新视觉hd电影/新视觉电影高清
精品导视	jpdaoshi	精品导视
成都每日购物频道	cdtv_8	成都每日购物频道/成都每日购物/成都电视台每日购物频道/成都电视台每日购物/每日购物/cdtv8每日购物/cdtv8
天津新闻频道	tjtv2	天津新闻频道/天津新闻/天津电视台新闻频道/天津电视台新闻/tjtv1/天津一套/天津一/天津1套/天津1/天津一台/天津1台
XJTV9	xjtv9	xjtv9/新疆电视台维语经济生活频道/新疆电视台维语经济生活/新疆电视台第九频道维语经济生活频道/新疆电视台第九频道维语经济生活/新疆电视台九频道/新疆电视台九/新疆电视台九套维语经济生活频道/新疆电视台九套维语经济生活/新疆台9频道/新疆台9/新疆维语经济生活频道/新疆维语经济生活/新疆九套/新疆九/新疆9套/新疆9/新疆九台/新疆9台
新疆教育台	xetv	新疆教育台/新疆教育/新疆教育电视台/新疆教育电视
云南都市频道	yntv2	云南都市频道/云南都市/云南电视台都市频道/云南电视台都市/yntv2/云南二套/云南二/云南2套/云南2/云南二台/云南2台/云南经济生活/云南电视台经济生活频道/云南电视台经济生活/云南经济生活频道
云南影视频道	yntv5	云南影视频道/云南影视/云南电视台影视频道/云南电视台影视/yntv5/云南五套/云南五/云南5套/云南5/云南五台/云南5台/云南电影频道/云南电影/云南电视台影视剧频道/云南电视台影视剧/云南影视剧频道/云南影视剧
云南公共频道	yntv6	云南公共频道/云南公共/云南电视台公共频道/云南电视台公共/yntv6/云南6台/云南6/云南6套/云南六套/云南六/云南六台
昆明影视频道	kmtv5	昆明影视频道/昆明影视/昆明电视台影视频道/昆明电视台影视/kmtv5/昆明五套/昆明五/昆明5套/昆明5/昆明五台/昆明5台
浙江卫视香港	zjtv1_hk	浙江卫视香港
浙江卫视美洲	zjtv12	浙江卫视美洲
杭州精品剧场	htv8	杭州精品剧场/杭州电视台精品剧场
宁波少儿频道	nbtv5	宁波少儿频道/宁波少儿/宁波电视台第五频道/宁波电视台第五/宁波台少儿频道/宁波台少儿/nbtv5/宁波五套/宁波五/宁波少儿台
南宁新闻综合频道	nanningtv1	南宁新闻综合频道/南宁新闻综合/南宁电视台新闻综合频道/南宁电视台新闻综合/南宁台新闻综合频道/南宁台新闻综合/南宁新闻频道/南宁新闻/南宁综合频道/南宁综合/南宁新闻综合频道台/南宁新闻台/南宁综合台
银川台生活频道	yinchuang2	银川台生活频道/银川台生活/银川电视台生活频道/银川电视台生活/银川生活频道/银川生活/银川生活台
威海公共频道	weihai2	威海公共频道/威海公共/威海电视台公共频道/威海电视台公共/威海2套/威海2/威海电视台二套/威海电视台二/威海二套/威海二/威海电视台2/威海2台/威海二台
秦皇岛新闻台	qinhuangdao1	秦皇岛新闻台/秦皇岛新闻/秦皇岛电视台新闻频道/秦皇岛电视台新闻/秦皇岛1台/秦皇岛1/秦皇岛1套/秦皇岛新闻综合频道/秦皇岛新闻综合/秦皇岛一套/秦皇岛一/秦皇岛一台/qhd1/秦皇岛电视台1
绍兴文化影视频道	shaoxin1	绍兴文化影视频道/绍兴文化影视/绍兴电视台文化影视频道/绍兴电视台文化影视/绍兴影视频道/绍兴影视/绍兴电视台影视频道/绍兴电视台影视/绍兴电视台娱乐频道/绍兴电视台娱乐/绍兴影视娱乐频道/绍兴影视娱乐
车迷频道	bamc1	车迷频道/车迷/数字电视车迷频道/数字电视车迷
新娱乐	bamc7	新娱乐/新娱乐电视频道/新娱乐电视
弈坛春秋	bamc10	弈坛春秋/弈坛春秋频道/围棋弈坛春秋
北大荒资讯频道	bdhzx	北大荒资讯频道/北大荒资讯/北大荒电视台资讯频道/北大荒电视台资讯/北大荒资讯电视台/北大荒资讯电视
亚洲新闻台	cna	亚洲新闻台/亚洲新闻/亚洲新闻电视台/亚洲新闻电视/cna/channel newsasia/channel new asia/news asia/channel news asi/channel news asia 亞洲新聞台/channel news asia 亞洲新聞
卫视电影台	star_chinese_movies_cn	卫视电影台/卫视电影/star chinese movies/星空卫视电影台/星空卫视电影/星空电影台/星空电影/star chinese mov/star chinese movie
IPTV魅力时尚	iptvmlss	iptv魅力时尚/魅力时尚
高清电影频道	gqdynvod	高清电影频道/高清电影/nvod高清电影/nvod 高清电影/电影频道高清
运通财经台	mod_206	运通财经台/运通财经/通运财经台/通运财经/财经
IPTV8PLUS	iptv8	iptv8plus
IPTV相声小品	iptvxsxp	iptv相声小品/iptv相声
超级玩家	cjwj	超级玩家
NOW SPORTS 6	now_sports6	now sports 6/第636频道/第636/636频道/636/636台/第636台
惠州一套	gdhztv1	惠州一套/惠州一/惠州电视台一套/惠州电视台一/惠州频道/惠州
吉林市新闻频道	jlctv1	吉林市新闻频道/吉林市新闻/吉林市电视台新闻综合频道/吉林市电视台新闻综合/吉林市新闻台
慈溪点歌台	cxdgt	慈溪点歌台/慈溪点歌
扬州新闻频道	yztv1	扬州新闻频道/扬州新闻/扬州电视台新闻频道/扬州电视台新闻/扬州一套/扬州一/扬州一台
连云港公共频道	lyg2	连云港公共频道/连云港公共/连云港电视台公共频道/连云港电视台公共
连云港影视频道	lyg3	连云港影视频道/连云港影视/连云港电视台影视频道/连云港电视台影视/连云港影视台
台州新闻综合	taizhou1	台州新闻综合/台州电视台新闻综合频道/台州电视台新闻综合/台州新闻综合台
台州文化生活	taizhou2	台州文化生活/台州电视台文化生活频道/台州电视台文化生活/台州影视文化频道/台州影视文化/台州影视文化台
台州公共频道	taizhou3	台州公共频道/台州公共/台州电视台公共财富频道/台州电视台公共财富/台州公共财富频道/台州公共财富/台州公共财富台
呼伦贝尔手机电视	hlbrtv4	呼伦贝尔手机电视/呼伦贝尔电视台手机电视频道/呼伦贝尔电视台手机电视
松原综合频道	sytv1	松原综合频道/松原综合/松原电视台新闻综合频道/松原电视台新闻综合/松原1/sytv1/松原一台/松原一/松原新闻综合台/松原新闻综合
齐齐哈尔公共	qqhrtv2	齐齐哈尔公共/齐齐哈尔电视台公共频道/齐齐哈尔电视台公共/齐齐哈尔都市频道/齐齐哈尔都市/齐齐哈尔2
蚌埠新闻频道	ahbbtv1	蚌埠新闻频道/蚌埠新闻/蚌埠电视台新闻频道/蚌埠电视台新闻/蚌埠新闻综合
如皋健康频道	rgyyyl	如皋健康频道/如皋健康/如皋电视台长寿健康频道/如皋电视台长寿健康/如皋电视台影视娱乐频道/如皋电视台影视娱乐/如皋影视娱乐台/如皋影视娱乐
自贡综合频道	sczgtv1	自贡综合频道/自贡综合/自贡电视台综合频道/自贡电视台综合
广安新闻综合频道	scgatv1	广安新闻综合频道/广安新闻综合/广安电视台新闻综合频道/广安电视台新闻综合
宜春三套	jxyctv3	宜春三套/宜春三/宜春电视台三套/宜春电视台三/宜春三台
绵阳新闻综合频道	scmytv1	绵阳新闻综合频道/绵阳新闻综合/绵阳电视台新闻综合频道/绵阳电视台新闻综合/绵阳综合/绵阳1
绵阳公共频道	scmytv2	绵阳公共频道/绵阳公共/绵阳电视台公共频道/绵阳电视台公共/绵阳2/绵阳都市生活频道/绵阳都市生活/绵阳二台/绵阳二
惠州二套	gdhztv2	惠州二套/惠州二/惠州电视台二套/惠州电视台二/惠州二台
梅州影视文艺频道	gdmztv3	梅州影视文艺频道/梅州影视文艺/梅州电视台影视文艺频道/梅州电视台影视文艺/mztv3/梅州影视文艺台
清远综合频道	gdqytv1	清远综合频道/清远综合/清远电视台综合频道/清远电视台综合/清远电视台新闻综合频道/清远电视台新闻综合/清远新闻综合频道/清远新闻综合/清远新闻综合台
鼎城电视频道	cddc	鼎城电视频道/鼎城电视/鼎城电视台
十堰导视频道	hbsytv5	十堰导视频道/十堰导视/十堰电视台导视频道/十堰电视台导视/十堰导视台
安阳新闻综合	aytv1	安阳新闻综合/安阳电视台综合频道/安阳电视台综合/安阳一套/安阳一/安阳一台
安阳公共频道	aytv2	安阳公共频道/安阳公共/安阳电视台公共频道/安阳电视台公共/安阳都市频道/安阳都市/安阳二套/安阳二/安阳法制频道/安阳法制/安阳二台
鹤壁生活频道	hebitv2	鹤壁生活频道/鹤壁生活/鹤壁电视台生活频道/鹤壁电视台生活/鹤壁生活台
乐山公共新农村	leshantv2	乐山公共新农村/乐山电视台公共新农村频道/乐山电视台公共新农村
东风卫视	aziotv	东风卫视/东风卫视频道/台湾东风卫视/东风电视台/东风电视/东风卫视台/东风频道/东风/東風電視/azio tv
朝阳公共生活频道	chytv1	朝阳公共生活频道/朝阳公共生活/朝阳电视台公共生活频道/朝阳电视台公共生活/朝阳公共频道/朝阳公共/朝阳公共台
NEWTV健康有约	jkyouyue	newtv健康有约
优视影院	youshiyy	优视影院
吉本东风	azio_asia	吉本东风/新亚东风卫视/新亚东风/東風國際頻道
乌兰察布经济生活	wlcbtv2	乌兰察布经济生活/乌兰察布电视台经济生活频道/乌兰察布电视台经济生活/乌兰察布2/乌兰察布二台/乌兰察布二
东海文娱频道	dhzyshpd	东海文娱频道/东海文娱/东海电视台文娱频道/东海电视台文娱/东海娱乐生活频道/东海娱乐生活
阳泉娱乐频道	qtv4	阳泉娱乐频道/阳泉娱乐/阳泉电视台娱乐频道/阳泉电视台娱乐/阳泉娱乐台
辽阳新闻综合	layatv1	辽阳新闻综合/辽阳电视台新闻综合频道/辽阳电视台新闻综合/辽阳电视台新闻频道/辽阳电视台新闻/辽阳新闻频道/辽阳新闻/辽阳新闻台
辽阳都市频道	layatv2	辽阳都市频道/辽阳都市/辽阳电视台都市频道/辽阳电视台都市
衢州生活娱乐	qztv_2	衢州生活娱乐/衢州电视台生活娱乐频道/衢州电视台生活娱乐/qztv2/衢州电视台二套/衢州电视台二/衢州公共频道/衢州公共/衢州二台/衢州二/衢州公共台
阳江公共频道	yangjtv2	阳江公共频道/阳江公共/阳江电视台公共频道/阳江电视台公共
贵港新闻综合频道	ggtv1	贵港新闻综合频道/贵港新闻综合/贵港电视台新闻综合频道/贵港电视台新闻综合
哈哈动画	hahadh	哈哈动画
王牌综艺	wangpaizy	王牌综艺
时尚旅游	shishanglv	时尚旅游
江宁新闻频道	jnxwzh	江宁新闻频道/江宁新闻/江宁新闻台
拉萨台	lasatv1	拉萨台/拉萨/拉萨市台/拉萨市
塔城一套	tctv1	塔城一套/塔城一/塔城电视台一套/塔城电视台一/塔城新闻综合频道/塔城新闻综合/塔城新闻综合台/塔城一台
塔城二套	tctv2	塔城二套/塔城二/塔城电视台二套/塔城电视台二/哈语新闻综合/哈语新闻台/哈语新闻/塔城二台
漯河都市频道	lhtv1	漯河都市频道/漯河都市/漯河电视台都市频道/漯河电视台都市
漯河影视频道	lhtv2	漯河影视频道/漯河影视/漯河电视台影视频道/漯河电视台影视
宜昌旅游生活	yichangtv3	宜昌旅游生活/宜昌电视台旅游生活频道/宜昌电视台旅游生活/宜昌电视台旅游商务频道/宜昌电视台旅游商务/宜昌综艺台/宜昌综艺/宜昌旅游台/宜昌旅游
晋江影视频道	jinjiangtv2	晋江影视频道/晋江影视/晋江电视台影视频道/晋江电视台影视/晋江影视台
怀化新闻综合频道	hnhhtv1	怀化新闻综合频道/怀化新闻综合/怀化电视台新闻综合频道/怀化电视台新闻综合/怀化新闻台/怀化新闻
怀化经济频道	hnhhtv2	怀化经济频道/怀化经济/怀化电视台经济频道/怀化电视台经济/怀化经济台
张家界新闻频道	zjjtv1	张家界新闻频道/张家界新闻/张家界电视台新闻频道/张家界电视台新闻/张家界1/张家界一台/张家界一
张家界娱乐频道	zjjtv4	张家界娱乐频道/张家界娱乐/张家界电视台娱乐频道/张家界电视台娱乐/张家界4/张家界四台/张家界四
来宾市综合频道	lbtvca1	来宾市综合频道/来宾市综合/来宾市电视台综合频道/来宾市电视台综合/来宾综合台/来宾综合/来宾综合频道
NEWTV明星大片	mxdapian	newtv明星大片
CGTN 西语	cctv17	cgtn 西语/cgtn西班牙语频道/cgtn西班牙语/cctve/cctv西语/cctv西语频道/cctv西语台/中央西语频道/中央西语/中央西语台/cctv西班牙语/中央西班牙语
CGTN 纪录英	cctv18	cgtn 纪录英
CGTN	cctv19	cgtn/中国国际电视台新闻频道/中国国际电视台新闻/cctvnews语频道/cctvnews语/cctvnews/中央电视台英语新闻频道/中央电视台英语新闻/中央电视台news/cctv英语国际/中央news/cctv－news/cctv英语/cctv英语频道/中央电视台英语新闻台/中央英文/中央英文频道/中央英语频道/英语频道/cctv news
CGTN香港	cctv19_hk	cgtn香港
CCTV4欧洲	cctveurope	cctv4欧洲/cctv4欧洲频道/cctv欧洲/cctv欧洲频道/cctv欧洲台/中央欧洲台/中央欧洲/cctv4中文国际（欧）/中央电视台四套欧洲频道/中央电视台四套欧洲/cctv4欧洲台/cctv4欧洲版
CCTV4美洲	cctvamericas	cctv4美洲/cctv4美洲频道/cctv美洲/cctv美洲频道/cctv美洲台/中央美洲台/中央美洲/cctv4美洲台/cctv4美洲版/cctv4(美)
CGTN 法语	cctvf	cgtn 法语/中国国际电视台法语频道/中国国际电视台法语/cctvf法语/cctv法语/cctv法语频道/cctv法语台/中央法语频道/中央法语/中央法语台/cctv－français/cctvf/cctvf 法語頻道
CGTN 阿语	cctva	cgtn 阿语/中国国际电视台阿语频道/中国国际电视台阿语/cctva阿拉伯语频道/cctva阿拉伯语/cctv阿拉伯频道/cctv阿拉伯/cctv阿拉伯语/cctv阿语/中央阿拉伯语/cctva/央视阿拉伯语/cctva阿语/cgtn阿拉伯语
CGTN 俄语	cctvr	cgtn 俄语/中国国际电视台俄语频道/中国国际电视台俄语/cctv俄语/俄语频道/俄语/中央俄语频道/中央俄语/cctvr/央视俄语/cgtn俄语
中国电影频道北美版	china_movie_channel_na	中国电影频道北美版
风云剧场	cctvpayfee4	风云剧场/中数传媒风云剧场/cctv风云剧场/风云剧场频道/中央电视台风云剧场/风云剧场台/中央风云剧场
怀旧剧场	cctvpayfee7	怀旧剧场/中数传媒怀旧剧场/cctv怀旧剧场/央视怀旧剧场/怀旧剧场频道/中央电视台怀旧剧场/中央怀旧剧场/怀旧经典/cctv怀旧经典/怀旧剧场台
女性时尚	cctvpayfee9	女性时尚/中数传媒女性时尚/cctv女性时尚/cctv女性频道/cctv女性/中央电视台女性时尚/央视女性时尚/中央女性时尚
CCTV娱乐	cctvpayfee10	cctv娱乐/中数传媒央视娱乐/cctv娱乐频道/cctv娱乐台
高尔夫网球	cctvpayfee13	高尔夫网球/中数传媒高尔夫网球/高尔夫网球频道/cctv高尔夫网球/cctv高尔夫网球频道/央视高尔夫网球频道/央视高尔夫网球/风云高网/高尔夫.网球/cctv高网/cctv高尔夫.网球/高尔夫•网球
央视精品	cctvpayfee14	央视精品/cctv央视文化精品/中数传媒央视精品/cctv央视精品/央视精品频道/cctv央视精品频道/央视文化精品/文化精品/cctv精品
中视购物	cctvpayfee15	中视购物/cctv中视购物/中数传媒中视购物/中视购物频道/cctv中视购物频道
彩民在线	cctvpayfee16	彩民在线/中数传媒彩民在线/彩民在线频道/山西电视台彩民在线频道/山西电视台彩民在线/山西彩民在线/山西彩民在线频道
法律服务	cctvpayfee17	法律服务/中数传媒法律服务/央视法律服务频道/央视法律服务/cctv法律服务频道/cctv法律服务/央视法律服务台/cctv法律服务台
梨园	cctvpayfee20	梨园/cctv梨园/中数传媒梨园频道/中数传媒梨园/河南电视台梨园频道/河南电视台梨园/河南梨园频道/河南梨园/梨园春频道/梨园春/梨园曲艺/梨园剧场/河南梨园台/梨园频道
留学世界	cctvpayfee24	留学世界/中数传媒留学世界/浙江电视台留学世界频道/浙江电视台留学世界/浙江电视台留学频道/浙江电视台留学/浙江留学世界频道/浙江留学世界/浙江留学频道/浙江留学/浙江留学世界台/浙江留学台
青年学苑	cctvpayfee25	青年学苑
早期教育	cctvpayfee33	早期教育/中数传媒早期教育/中国教育电视台早期教育频道/中国教育电视台早期教育/早期教育频道
CCTV证券资讯	cctvcj	cctv证券资讯/cctv央视证券资讯/央视证券资讯/中央电视台证券资讯/cctv证券/cctv证券资讯频道/cctv证券频道/证券资讯/cctv证券信息/证劵资讯/中央证券资讯
CCTV中学生频道	cctvpayfee35	cctv中学生频道/cctv中学生/中学生频道/中学生/央视中学生频道/央视中学生/中学生同步辅导/中学生辅导
CCTV央视台球	cctvpayfee36	cctv央视台球/央视台球/cctv台球频道/cctv台球/央视台球频道
中华美食	china_foodtv	中华美食/中华美食频道/青岛中华美食/chc中华美食
全国党教	dangjiao	全国党教/全国党建
HBO香港	hbo_hk	hbo香港
HBO台湾	hbo_tw	hbo台湾
AXN	axn_tw	axn/axn频道/axn中文/索尼动作频道/索尼动作/axn电影台/axn电影/axn電視台/axn電視/axn索尼动作/索尼电影
AXN香港	axn_hk	axn香港
TVB8台湾	tvb8_tw	tvb8台湾
星空卫视香港	xingkong1_hk	星空卫视香港
香港卫视	hks	香港卫视
CGTN 纪录(英)	duer_0_0	cgtn 纪录(英)/中国国际电视台纪录频道（英文）/cctv9（英）/中央9台（英文）/中央九台（英文）/cctv9纪录（英文）/央视9频道（英文）/cctv纪录（英文）/cctv国际纪录/cgtn纪录
高邮新闻综合频道	duer_0_1	高邮新闻综合频道/高邮新闻综合
高尔夫频道	duer_0_2	高尔夫频道/高尔夫/中数传媒高尔夫/央视高尔夫
英语辅导频道	duer_0_3	英语辅导频道/英语辅导/中数传媒英语辅导
GTV游戏竞技	duer_0_4	gtv游戏竞技/中数传媒游戏竞技/gtv游戏竞技频道/游戏竞技/游戏竞技频道/辽宁游戏竞技/游戏竟技/辽宁竞技/游戏竞技台
孕育指南	duer_0_5	孕育指南/中数传媒孕育指南/孕育指南频道/cctv孕育指南
江苏靓妆频道	duer_0_6	江苏靓妆频道/江苏靓妆/江苏电视台靓妆频道/江苏电视台靓妆/江苏电视靓妆频道/江苏电视靓妆/靓妆频道/靓妆
海外影院	duer_0_7	海外影院/sitv海外影院/sitv海外影院频道/上海海外影院频道/上海海外影院/文广数字电视sitv海外影院
武术世界	duer_0_8	武术世界/河南电视台武术世界频道/河南电视台武术世界/河南武术世界/河南台武术世界频道/河南台武术世界
碟市频道	duer_0_9	碟市频道/碟市/湖北碟市频道/湖北碟市/数字电视碟市频道/数字电视碟市
3D电视试验频道	duer_0_10	3d电视试验频道/3d电视试验/中国3d电视试验频道/中国3d电视试验/3d试验频道/3d试验/中国3d试验频道/中国3d试验/中央电视台3d频道/中央电视台3d/数字电视3d频道/数字电视3d/3d频道/3d/3d测试/cctv3d/央视3d/中国3d电视频道/中国3d电视/3d高清试验频道/3d高清试验/央视3d试验/中国3d体验频道/中国3d体验/3d体验频道/3d体验/3d实验频道/3d实验
文物宝库	duer_0_11	文物宝库/河南电视台文物宝库频道/河南电视台文物宝库/河南文物宝库/河南文物宝库频道
幼儿教育	duer_0_12	幼儿教育/幼儿教育频道/江苏幼儿教育频道/江苏幼儿教育
CCTV老故事	duer_0_13	cctv老故事/cctv老故事频道/老故事频道/老故事/老故事  cctv
家庭剧场1套	duer_0_14	家庭剧场1套/家庭剧场1/家庭剧场一套/家庭剧场一
家庭剧场2套	duer_0_15	家庭剧场2套/家庭剧场2/家庭剧场二套/家庭剧场二
家庭剧场3套	duer_0_16	家庭剧场3套/家庭剧场3/家庭剧场三套/家庭剧场三/辽宁热播剧场
家庭影院1套	duer_0_17	家庭影院1套/家庭影院1/家庭影院一套/家庭影院一
家庭影院2套	duer_0_18	家庭影院2套/家庭影院2/家庭影院二套/家庭影院二
家庭影院3套	duer_0_19	家庭影院3套/家庭影院3/家庭影院三套/家庭影院三
家庭影院4套	duer_0_20	家庭影院4套/家庭影院4/家庭影院四套/家庭影院四
海外剧场	duer_0_21	海外剧场/辽宁海外剧场频道/辽宁海外剧场
刑侦剧场	duer_0_22	刑侦剧场/辽宁刑侦剧场/刑侦剧场频道
老电影	duer_0_23	老电影/老电影频道/辽宁老电影频道/辽宁老电影
纪录片	duer_0_24	纪录片/辽宁纪录片频道/辽宁纪录片
探索集锦	duer_0_25	探索集锦/探索集锦频道/辽宁探索集锦频道/辽宁探索集锦
地理杂志	duer_0_26	地理杂志/地理杂志频道/辽宁地理杂志频道/辽宁地理杂志
娱乐精选	duer_0_27	娱乐精选/娱乐精选频道/辽宁娱乐精选
卡通剧场	duer_0_28	卡通剧场/卡通剧场频道/辽宁卡通剧场频道/辽宁卡通剧场/幸福卡通频道/幸福卡通
家庭生活	duer_0_29	家庭生活/家庭生活频道/辽宁家庭生活频道/辽宁家庭生活
家庭旅游	duer_0_30	家庭旅游/家庭旅游频道/辽宁家庭旅游频道/辽宁家庭旅游
重庆杂技频道	duer_0_31	重庆杂技频道/重庆杂技/重庆杂技台
精品欣赏	duer_0_32	精品欣赏
城市电视	duer_0_33	城市电视
探索纪实	duer_0_34	探索纪实/华数探索纪实/华数探索纪录/探索纪录/探索记录/华数探索记录/探索纪事/高清探秘频道/高清探秘
风尚音乐	duer_0_35	风尚音乐/华数风尚音乐
欧美影院	duer_0_36	欧美影院/华数欧美影院
城市建设	duer_0_37	城市建设
动漫视界	duer_0_38	动漫视界
亚洲电影	duer_0_39	亚洲电影
音乐电视	duer_0_40	音乐电视
中博剧场频道	duer_0_41	中博剧场频道/中博剧场/中博电视剧/中博高清电视剧
中博综艺频道	duer_0_42	中博综艺频道/中博综艺/中博高清综艺/中博大观
中博影院频道	duer_0_43	中博影院频道/中博影院/中博电影频道/中博电影/中博高清影院/中博高清影视
中博时尚频道	duer_0_44	中博时尚频道/中博时尚/中博高清时尚
中博探索频道	duer_0_45	中博探索频道/中博探索
中博教育频道	duer_0_46	中博教育频道/中博教育
DOX韩流	duer_0_47	dox韩流/dox韩流频道/韩流新映/韩剧新映/高清韩流剧场/韩潮放送高清
高清影视频道（地区）	duer_0_48	高清影视频道（地区）
高清探索频道（地区）	duer_0_49	高清探索频道（地区）
高清综艺频道（地区）	duer_0_50	高清综艺频道（地区）
高清综合频道（地区）	duer_0_51	高清综合频道（地区）
少儿动漫	duer_0_52	少儿动漫/华数少儿动漫/动漫天地
动感英超	duer_0_53	动感英超/华数动感英超/动感体育
大众影视	duer_0_54	大众影视
欧美电影	duer_0_55	欧美电影
NV学习频道	duer_0_56	nv学习频道/nv学习
NV阿里郎频道	duer_0_57	nv阿里郎频道/nv阿里郎
NV功夫频道	duer_0_58	nv功夫频道/nv功夫
NV喜剧频道	duer_0_59	nv喜剧频道/nv喜剧
NV惊奇频道	duer_0_60	nv惊奇频道/nv惊奇
NV国际频道	duer_0_61	nv国际频道/nv国际
NV华语频道	duer_0_62	nv华语频道/nv华语
NV经典频道	duer_0_63	nv经典频道/nv经典
综艺晚会	duer_0_64	综艺晚会
中央远教一套	duer_0_65	中央远教一套/中央远教一
中央远教二套	duer_0_66	中央远教二套/中央远教二
中央远教三套	duer_0_67	中央远教三套/中央远教三
中央远教四套	duer_0_68	中央远教四套/中央远教四
星元视讯	duer_0_69	星元视讯
交通·旅游	duer_0_70	交通·旅游/交通旅游
靓装	duer_0_71	靓装
同步剧场	duer_0_72	同步剧场/国内剧场
探索发现	duer_0_73	探索发现
音乐会	duer_0_74	音乐会/音乐汇
多彩云·电影	duer_0_75	多彩云·电影/贵州精选剧场
高清畅享馆	duer_0_76	高清畅享馆
NVOD视尚影院	duer_0_77	nvod视尚影院
NVOD偶像剧场	duer_0_78	nvod偶像剧场/陕西偶像剧场频道/陕西偶像剧场
NVOD亚洲剧场	duer_0_79	nvod亚洲剧场
NVOD动感影院	duer_0_80	nvod动感影院
NVOD先锋剧场	duer_0_81	nvod先锋剧场/nvod先锋影剧
NVOD传奇	duer_0_82	nvod传奇
骄阳剧场	duer_0_83	骄阳剧场/江西骄阳剧场
体坛集锦频道	duer_0_84	体坛集锦频道/体坛集锦
综艺荟萃频道	duer_0_85	综艺荟萃频道/综艺荟萃/高清综艺荟萃
电子竞技	duer_0_86	电子竞技/华数电子竞技
体彩宝	duer_0_87	体彩宝/华数体彩宝/快彩宝频道/快彩宝
赛事精选-1	duer_0_88	赛事精选1/赛事精选一台/赛事精选一
赛事精选-2	duer_0_89	赛事精选2/赛事精选二台/赛事精选二
赛事精选-3	duer_0_90	赛事精选3/赛事精选三台/赛事精选三
香江影院	duer_0_91	香江影院
IPTV海外影院	duer_0_92	iptv海外影院
热门剧场	duer_0_93	热门剧场
武侠剧场	duer_0_94	武侠剧场
古装剧场	duer_0_95	古装剧场/bestv古装剧场
喜剧剧场	duer_0_96	喜剧剧场
谍战剧场	duer_0_97	谍战剧场
热门动画	duer_0_98	热门动画/iptv热门动画
经典动画	duer_0_99	经典动画
英语世界	duer_0_100	英语世界
IPTV5+	duer_0_101	iptv5+/iptv精品体育
IPTV6+	duer_0_102	iptv6+/iptv精品电影
IPTV8+	duer_0_103	iptv8+/iptv精品大剧
睛彩巴扎1	duer_0_104	睛彩巴扎1/经典影视频道/经典影视
睛彩巴扎2	duer_0_105	睛彩巴扎2
睛彩巴扎3	duer_0_106	睛彩巴扎3
IPTV收视指南	duer_0_107	iptv收视指南/收视指南/iptv收视导视
中博英剧频道	duer_0_108	中博英剧频道/中博英剧
中博韩剧频道	duer_0_109	中博韩剧频道/中博韩剧
港剧风云	duer_0_110	港剧风云/iptv港剧剧场
NVOD环球影院	duer_0_111	nvod环球影院
佳片赏析	duer_0_112	佳片赏析
IPTV娱乐精选	duer_0_113	iptv娱乐精选
热门综艺	duer_0_114	热门综艺
怀旧金曲	duer_0_115	怀旧金曲
科技探索	duer_0_116	科技探索
自然大观	duer_0_117	自然大观
CCTV微电影	duer_0_118	cctv微电影/cctv微电影频道/中国微电影
CCTV西部旅游	duer_0_119	cctv西部旅游/cctv西部旅游频道/西部旅游
IPTV理财	duer_0_121	iptv理财
阿拉一家门	duer_0_122	阿拉一家门
我爱上海	duer_0_123	我爱上海
快乐学堂	duer_0_124	快乐学堂
两岸四地GO	duer_0_125	两岸四地go
IPTV出行	duer_0_126	iptv出行
淘电影	duer_0_127	淘电影
天华经典影院	duer_0_128	天华经典影院/高清经典影院/华视影院
高清时尚	duer_0_129	高清时尚/天途高清时尚
天山剧场	duer_0_130	天山剧场/维语电影频道/维语电影/xjtv13
娱乐巴扎	duer_0_131	娱乐巴扎/xjtv14
教育在线	duer_0_132	教育在线/xjtv15
平度影视	duer_0_133	平度影视/平度电视台影视频道/平度电视台影视
高清NBA	duer_0_134	高清nba
精彩影视	duer_0_135	精彩影视/华数精彩影视频道/华数精彩影视/睛彩影视
东方物流	duer_0_136	东方物流/东方物流频道
点掌财经	duer_0_137	点掌财经
电影导视	duer_0_138	电影导视/cibn电影导视
CIBN电影频道	duer_0_139	cibn电影频道/cibn电影
喜剧	duer_0_140	喜剧/cibn喜剧/cibn喜剧影院/cibn华视院线
精品影院	duer_0_141	精品影院/cibn精品影院
CIBN热播剧场	duer_0_142	cibn热播剧场
综艺频道	duer_0_143	综艺频道/综艺/cibn综艺频道/cibn综艺
动漫频道	duer_0_144	动漫频道/动漫/cibn动漫频道/cibn动漫
CIBN音乐频道	duer_0_145	cibn音乐频道/cibn音乐
高清风尚频道	duer_0_146	高清风尚频道/高清风尚/高清nvod风尚
华视院线	duer_0_147	华视院线/华视高清院线/华视经典影院
华视剧场	duer_0_148	华视剧场/华视高清剧场
华视动漫	duer_0_149	华视动漫/华视高清动漫
乐天高清剧场	duer_0_150	乐天高清剧场/乐天高清剧场频道/乐天剧场高清
乐天高清影院	duer_0_151	乐天高清影院/乐天高清影院频道/乐天影院高清
乐天影视	duer_0_152	乐天影视/乐天影视频道
乐天影视高清	duer_0_153	乐天影视高清/乐天高清综合
韩潮放送	duer_0_154	韩潮放送/中博潮流放送/中博韩潮放送
时尚综艺	duer_0_155	时尚综艺
深圳龙华频道	duer_0_156	深圳龙华频道/深圳龙华/深圳电视台龙华频道/深圳电视台龙华
英伦风尚	duer_0_157	英伦风尚/中博英伦风尚/中博英伦风
中博动作电影	duer_0_158	中博动作电影/中博影视/中博电影/中博影院
中博经典影院	duer_0_159	中博经典影院/中博时尚/中博高清电影
中博视界综艺	duer_0_160	中博视界综艺
中博高清视界	duer_0_161	中博高清视界
中博高清剧场	duer_0_162	中博高清剧场
IPTV新导视	duer_0_163	iptv新导视/新导视
CIBN古装剧场	duer_0_164	cibn古装剧场
CIBN骄阳剧场	duer_0_165	cibn骄阳剧场
星元票房	duer_0_166	星元票房
DOX环映	duer_0_167	dox环映
DV生活频道	duer_0_168	dv生活频道/dv生活/深圳电视台dv生活频道/深圳电视台dv生活/深视dv生活/深圳dv/dv 生活
TVS-1经济频道	duer_0_169	tvs1经济频道/tvs1经济/南方电视台经济频道/南方电视台经济/tvs1/南方tvs1/南方tvs1经济频道/南方tvs1经济/南方电视台tvs1/南方台经济频道/南方台经济/南方一套/南方一/南方经济科教/南方1套/南方1/南方一台/南方1台/南方经济频道/南方经济/南方经视/广东经济科教
TVS-3综艺频道	duer_0_170	tvs3综艺频道/tvs3综艺/南方电视台综艺频道/南方电视台综艺/南方tvs3/南方tvs3综艺频道/南方tvs3综艺/南方电视台tvs3/南方台综艺频道/南方台综艺/tvs3/南方综艺/南方三套/南方三/南方3套/南方3/南方综艺频道/广东综艺/南方三台
TVS-4影视频道	duer_0_171	tvs4影视频道/tvs4影视/南方电视台影视频道/南方电视台影视/tvs4/南方4台/南方4/南方tvs4/南方tvs4影视频道/南方tvs4影视/南方电视台tvs4/南方四台/南方四/南方台影视频道/南方台影视/南方影视/南方四套/南方4套/南方影视频道/广东影视
TVS-5少儿频道	duer_0_172	tvs5少儿频道/tvs5少儿/南方电视台少儿频道/南方电视台少儿/南方tvs5/南方tvs5少儿频道/南方tvs5少儿/南方电视台tvs5/南方台少儿频道/南方台少儿/南方儿频道/南方儿/南方5套/南方5/南方5台/南方少儿频道tvs5/广东南方少儿频道/广东南方少儿/tvs5 南方少儿频道/tvs5 南方少儿/南方少儿tvs5/tvs5南方电视台少儿频道/tvs5南方电视台少儿/南方少儿频道/南方少儿/tvs5/广东少儿/南方五套/南方五/南方五台
TVS-2南方卫视	duer_0_173	tvs2南方卫视/广东南方都市频道/广东南方都市/南方都市频道tvs2/南方都市/南方卫视(省内版)/广东南方卫视地面版/tvs2
大庆公共频道	duer_0_174	大庆公共频道/大庆公共/大庆电视台公共频道/大庆电视台公共/大庆直播频道/大庆直播/大庆台直播台/大庆台直播
济源教育台	duer_0_175	济源教育台/济源教育/济源教育电视台/济源教育电视/济源教育频道/济源2
湖北公共·新闻	duer_0_176	湖北公共·新闻/湖北电视台公共·新闻频道/湖北电视台公共·新闻/湖北省电视台公共频道/湖北省电视台公共/湖北公共台/湖北公共/湖北电视台公共频道/湖北电视台公共
衡阳电视台	duer_0_177	衡阳电视台/衡阳电视/湖南衡阳电视台/湖南衡阳电视
江苏公共·新闻	duer_0_178	江苏公共·新闻/江苏电视台公共·新闻频道/江苏电视台公共·新闻/江苏电视公共频道/江苏电视公共/江苏公共台/江苏公共/江苏新闻频道/江苏新闻/江苏公共 新闻
无锡数字明珠剧场	duer_0_179	无锡数字明珠剧场/无锡电视台数字明珠剧场/无锡台数字明珠剧场/数字明珠频道/数字明珠/明珠频道/明珠/明珠剧场
吉视综艺·文化	duer_0_180	吉视综艺·文化/吉林电视台综艺·文化频道/吉林电视台综艺·文化/吉林法制电视台/吉林法制电视/吉林法制频道/吉林法制/吉视法制/吉林综艺文化频道/吉林综艺文化/吉视综艺 文化/吉视法制频道
山东有线齐鲁剧场	duer_0_181	山东有线齐鲁剧场/山东有线电视台齐鲁剧场/sdcatv齐鲁剧场/山东有线台齐鲁剧场/山东有线电视第六频道/山东有线电视第六/山东电视齐鲁剧场频道/山东电视齐鲁剧场/sdcatv6/齐鲁剧场/山东有线台齐鲁剧场台
欢乐童年	duer_0_182	欢乐童年/sdcatv少儿频道/sdcatv少儿/山东有线台少儿频道/山东有线台少儿/山东有线电视第八频道/山东有线电视第八/sdcatv8/山东有线少儿台/山东有线少儿
临汾图文频道	duer_0_183	临汾图文频道/临汾图文/临汾电视台图文频道/临汾电视台图文/临汾台图文频道/临汾台图文/临汾图文台
义乌稠州影院	duer_0_184	义乌稠州影院/义乌电视台稠州影院/义乌台稠州影院
义乌商城影院	duer_0_185	义乌商城影院/义乌电视台商城影院/义乌台商城影院/义乌商城影院频道/义乌电视台商城影院频道
广州移动	duer_0_186	广州移动/广州有线移动频道/广州有线移动/广东移动/移动频道/移动
新财经	duer_0_187	新财经/重庆电视台新财经/重庆新财经
重庆魅力时装频道	duer_0_188	重庆魅力时装频道/重庆魅力时装/cqtv魅力时装
天威TVG	duer_0_189	天威tvg
番禺频道	duer_0_190	番禺频道/番禺/公共(番禺)频道/公共(番禺)
四川星空城市频道	duer_0_191	四川星空城市频道/四川星空城市/四川广电星空城市电视/星空城市频道/星空城市/sctv星空/sctv星空城市
广西科教频道	duer_0_193	广西科教频道/广西科教
合肥公共频道	duer_0_194	合肥公共频道/合肥公共/合肥电视台公共频道/合肥电视台公共/巢湖明珠频道/巢湖明珠/巢湖明珠台
合肥文体博览	duer_0_195	合肥文体博览
合肥欢乐频道	duer_0_196	合肥欢乐频道/合肥欢乐
包头都市影视频道	duer_0_197	包头都市影视频道/包头都市影视/包头电视台都市影视频道/包头电视台都市影视/包头四套/包头四/包头影视/包头四台/包头影视台/包头影视频道
包头图文信息频道	duer_0_198	包头图文信息频道/包头图文信息/包头电视台图文信息频道/包头电视台图文信息/包头五套/包头五/包头五台
陕西八套	duer_0_199	陕西八套/陕西八/西部电影频道/西部电影/陕西8套/陕西8
西安教育频道	duer_0_200	西安教育频道/西安教育/西安教育电视台/西安教育电视
宝应1台	duer_0_201	宝应1台/宝应1/宝应电视台一套/宝应电视台一/宝应一台/宝应一
宝应2台	duer_0_202	宝应2台/宝应2/宝应电视台二套/宝应电视台二/宝应二台/宝应二
宝应3台	duer_0_203	宝应3台/宝应3/宝应电视台三套/宝应电视台三/宝应三台/宝应三
长沙互动频道	duer_0_204	长沙互动频道/长沙互动/长沙电视台互动频道/长沙电视台互动
大同健康导视频道	duer_0_205	大同健康导视频道/大同健康导视/大同电视台健康导视频道/大同电视台健康导视/大同健康导视台
尚TV	duer_0_206	尚tv/潮流风尚
数字大理	duer_0_207	数字大理
大理一台	duer_0_208	大理一台/大理一/大理电视台新闻综合频道/大理电视台新闻综合/大理市电视台/大理市电视/大理新闻综合频道/大理新闻综合/大理新闻综合台
大理二台	duer_0_209	大理二台/大理二/大理电视台影视公共频道/大理电视台影视公共/大理影视公共频道/大理影视公共/大理影视公共台
大理三台	duer_0_210	大理三台/大理三/大理电视台旅游文化娱乐频道/大理电视台旅游文化娱乐/大理旅游文化娱乐频道/大理旅游文化娱乐/大理旅游文化娱乐台
张家口新闻综合	duer_0_211	张家口新闻综合/张家口电视台新闻综合频道/张家口电视台新闻综合
张家口社会公共	duer_0_212	张家口社会公共/张家口电视台社会公共频道/张家口电视台社会公共
南通党建频道	duer_0_219	南通党建频道/南通党建/南通电视台党建频道/南通电视台党建
马鞍山影视频道	duer_0_220	马鞍山影视频道/马鞍山影视/马鞍山电视台影视频道/马鞍山电视台影视/马鞍山影视娱乐频道/马鞍山影视娱乐
黄山二套	duer_0_221	黄山二套/黄山二/黄山公共生活频道/黄山公共生活/黄山电视台二套/黄山电视台二/黄山二台
南靖综合频道	duer_0_222	南靖综合频道/南靖综合/南靖电视台综合频道/南靖电视台综合/南靖综合台
榆林一套	duer_0_223	榆林一套/榆林一/榆林电视台一套/榆林电视台一/榆林一台
榆林二套	duer_0_224	榆林二套/榆林二/榆林电视台二套/榆林电视台二/榆林二台
榆林三套	duer_0_225	榆林三套/榆林三/榆林电视台三套/榆林电视台三/榆林三台
宝鸡综合频道	duer_0_226	宝鸡综合频道/宝鸡综合/宝鸡电视台新闻综合频道/宝鸡电视台新闻综合/宝鸡1套/宝鸡1/宝鸡1台
宝鸡经济生活频道	duer_0_227	宝鸡经济生活频道/宝鸡经济生活/宝鸡电视台经济生活频道/宝鸡电视台经济生活/宝鸡2套/宝鸡2/宝鸡2台
宝鸡文化旅游频道	duer_0_228	宝鸡文化旅游频道/宝鸡文化旅游/宝鸡电视台文化旅游频道/宝鸡电视台文化旅游/宝鸡3套/宝鸡3/宝鸡3台
醉美遵义频道	duer_0_229	醉美遵义频道/醉美遵义/遵义电视台醉美遵义频道/遵义电视台醉美遵义/zytv5/醉美频道/醉美/遵义醉美遵义台/遵义醉美遵义
九江四套	duer_0_230	九江四套/九江四/九江电视台旅游文娱频道/九江电视台旅游文娱/jjtv4
九江五套	duer_0_231	九江五套/九江五/九江电视台城市生活频道/九江电视台城市生活/jjtv5
南充科教频道	duer_0_232	南充科教频道/南充科教/南充电视台科教频道/南充电视台科教/南充科教台
南充资讯频道	duer_0_233	南充资讯频道/南充资讯/南充电视台资讯频道/南充电视台资讯/南充资讯台
德阳互动生活频道	duer_0_234	德阳互动生活频道/德阳互动生活/德阳电视台互动生活频道/德阳电视台互动生活
德阳购物频道	duer_0_235	德阳购物频道/德阳购物/德阳电视台购物频道/德阳电视台购物/德阳购物台
绵阳文化旅游频道	duer_0_236	绵阳文化旅游频道/绵阳文化旅游/绵阳电视台文化旅游频道/绵阳电视台文化旅游/绵阳旅游信息/mytv5
广元科教频道	duer_0_237	广元科教频道/广元科教/广元电视台科教健康频道/广元电视台科教健康/广元科教健康台/广元科教健康
茂名综合频道	duer_0_238	茂名综合频道/茂名综合/茂名电视台综合频道/茂名电视台综合
博罗台	duer_0_239	博罗台/博罗/博罗电视台/博罗电视/博罗信息频道/博罗信息
韶关经济生活频道	duer_0_240	韶关经济生活频道/韶关经济生活/韶关电视台经济生活频道/韶关电视台经济生活/韶关公共/韶关经济生活台
睛彩郴州交通	duer_0_241	睛彩郴州交通/郴州电视台睛彩郴州交通频道/郴州电视台睛彩郴州交通/郴州睛彩郴州交通台/郴州睛彩郴州交通
湘潭公共都市频道	duer_0_242	湘潭公共都市频道/湘潭公共都市/湘潭电视台公共都市频道/湘潭电视台公共都市/湘潭都市/湘潭都市频道
湘潭法制频道	duer_0_243	湘潭法制频道/湘潭法制/湘潭电视台法制频道/湘潭电视台法制/湘潭法制台
湘潭经济频道	duer_0_244	湘潭经济频道/湘潭经济/湘潭电视台经济频道/湘潭电视台经济/湘潭经济台
株洲商务频道	duer_0_245	株洲商务频道/株洲商务/株洲电视台商务频道/株洲电视台商务/天睿传媒频道/天睿传媒/株洲商务台
常德公共频道	duer_0_246	常德公共频道/常德公共/常德电视台公共频道/常德电视台公共/常德公共台
常德都市频道	duer_0_247	常德都市频道/常德都市/常德电视台都市频道/常德电视台都市/常德都市台
常德武陵频道	duer_0_248	常德武陵频道/常德武陵/常德电视台武陵频道/常德电视台武陵/常德武陵台
咸宁新闻综合频道	duer_0_249	咸宁新闻综合频道/咸宁新闻综合/咸宁电视台新闻综合频道/咸宁电视台新闻综合/咸宁电视台/咸宁电视/咸宁1套/咸宁1/咸宁一台/咸宁一/咸宁新闻综合台
咸宁公共频道	duer_0_250	咸宁公共频道/咸宁公共/咸宁电视台公共频道/咸宁电视台公共/咸宁公共台
咸宁经济频道	duer_0_251	咸宁经济频道/咸宁经济/咸宁电视台经济频道/咸宁电视台经济/咸宁二台/咸宁二
荆门鄂中经视频道	duer_0_252	荆门鄂中经视频道/荆门鄂中经视/荆门电视台鄂中经视频道/荆门电视台鄂中经视/荆门鄂中经视台
滨州黄蓝文化频道	duer_0_253	滨州黄蓝文化频道/滨州黄蓝文化/滨州电视台黄蓝文化频道/滨州电视台黄蓝文化/滨州图文频道/滨州图文/黄蓝频道/黄蓝
许昌农业科教	duer_0_254	许昌农业科教/许昌电视台农业科技频道/许昌电视台农业科技/许昌农业科技教育频道/许昌农业科技教育/许昌农业科技教育台
睛彩许昌	duer_0_255	睛彩许昌/睛彩许昌频道
睛彩濮阳	duer_0_256	睛彩濮阳/濮阳电视台睛彩濮阳频道/濮阳电视台睛彩濮阳/睛彩濮阳频道
驻马店公共台	duer_0_257	驻马店公共台/驻马店公共/驻马店电视台公共频道/驻马店电视台公共/驻马店三套/驻马店三/驻马店三台
多彩云·韩剧	duer_0_258	多彩云·韩剧/贵州韩剧剧场/贵州韩剧专场
珠海导视	duer_0_259	珠海导视
贺州新闻综合频道	duer_0_260	贺州新闻综合频道/贺州新闻综合/贺州电视台新闻综合频道/贺州电视台新闻综合/贺州综合频道/贺州综合/贺州综合台
贺州生活频道	duer_0_261	贺州生活频道/贺州生活/贺州电视台生活频道/贺州电视台生活
贺州图文频道	duer_0_262	贺州图文频道/贺州图文/贺州电视台图文频道/贺州电视台图文/贺州图文信息
南充互动	duer_0_263	南充互动/南充电视台互动频道/南充电视台互动
乐山文化旅游	duer_0_264	乐山文化旅游/乐山电视台文化旅游频道/乐山电视台文化旅游/乐山文化旅游频道/乐山文化旅游台
乐山互动影视	duer_0_265	乐山互动影视/乐山电视台互动影视频道/乐山电视台互动影视/乐山互动影视频道/乐山互动影视台
通辽新闻综合频道	duer_0_266	通辽新闻综合频道/通辽新闻综合/通辽电视台新闻综合频道/通辽电视台新闻综合
通辽经济生活服务	duer_0_267	通辽经济生活服务/通辽电视台经济生活服务频道/通辽电视台经济生活服务/通辽经济生活频道/通辽经济生活/通辽经济生活台
通辽蒙古语综合	duer_0_268	通辽蒙古语综合/通辽电视台蒙古语综合频道/通辽电视台蒙古语综合/通辽蒙语综合频道/通辽蒙语综合/通辽蒙语综合台
通辽文体娱乐	duer_0_269	通辽文体娱乐/通辽电视台文体娱乐频道/通辽电视台文体娱乐/通辽生活频道/通辽生活/通辽生活台
镇海新闻综合频道	duer_0_270	镇海新闻综合频道/镇海新闻综合
镇海先锋频道	duer_0_271	镇海先锋频道/镇海先锋
益阳教育政法频道	duer_0_272	益阳教育政法频道/益阳教育政法/益阳电视台教育政法频道/益阳电视台教育政法/益阳教育政法台
武进新闻	duer_0_273	武进新闻/武进电视台新闻频道/武进电视台新闻
武进生活	duer_0_274	武进生活/武进电视台生活频道/武进电视台生活
丹阳新闻综合	duer_0_275	丹阳新闻综合/丹阳电视台新闻综合频道/丹阳电视台新闻综合
丹阳民生	duer_0_276	丹阳民生/丹阳电视台民生频道/丹阳电视台民生
丹阳快乐3	duer_0_277	丹阳快乐3/丹阳电视台快乐3频道/丹阳电视台快乐3
丹阳城市频道	duer_0_278	丹阳城市频道/丹阳城市/丹阳电视台城市频道/丹阳电视台城市/丹阳城市台
丹阳电视剧频道	duer_0_279	丹阳电视剧频道/丹阳电视剧/丹阳电视台电视剧频道/丹阳电视台电视剧/丹阳电视剧台
丹阳电影频道	duer_0_280	丹阳电影频道/丹阳电影/丹阳电视台电影频道/丹阳电视台电影/丹阳电影台
唐山少儿频道	duer_0_281	唐山少儿频道/唐山少儿/唐山电视台少儿科教频道/唐山电视台少儿科教/唐山导视
睛彩中原	duer_0_282	睛彩中原/河南电视台睛彩中原频道/河南电视台睛彩中原/hntv睛彩中原
传奇导视	duer_0_283	传奇导视/珠海传奇导视
射阳经济生活频道	duer_0_284	射阳经济生活频道/射阳经济生活/射阳电视台经济生活频道/射阳电视台经济生活/射阳经济生活台
射阳影视综艺频道	duer_0_285	射阳影视综艺频道/射阳影视综艺/射阳电视台影视综艺频道/射阳电视台影视综艺/射阳影视综艺台
天水旅游资讯频道	duer_0_286	天水旅游资讯频道/天水旅游资讯/天水电视台旅游资讯频道/天水电视台旅游资讯
睛彩四川	duer_0_287	睛彩四川
蚌埠文教频道	duer_0_288	蚌埠文教频道/蚌埠文教/蚌埠电视台文教频道/蚌埠电视台文教/bbtv文教
油田影视	duer_0_289	油田影视
睛彩兰州频道	duer_0_290	睛彩兰州频道/睛彩兰州
泰安先锋	duer_0_291	泰安先锋/泰山电视台先锋党建频道/泰山电视台先锋党建/泰山先锋
滨州科教频道	duer_0_292	滨州科教频道/滨州科教/滨州电视台科教频道/滨州电视台科教
淄博新视源导视	duer_0_293	淄博新视源导视/淄博电视台新视源导视频道/淄博电视台新视源导视/新视源导视
深圳国际频道(美洲)	duer_0_294	深圳国际频道(美洲)/深圳电视台国际频道(美洲)
塔城四套	duer_0_295	塔城四套/塔城四/塔城电视台四套/塔城电视台四/塔城影视剧频道/塔城影视剧/塔城影视剧台/塔城四台
漯河生活频道	duer_0_296	漯河生活频道/漯河生活/漯河电视台经济生活频道/漯河电视台经济生活/漯河电视台生活频道/漯河电视台生活/漯河经济生活频道/漯河经济生活/漯河生活台
平顶山教育频道	duer_0_297	平顶山教育频道/平顶山教育/平顶山电视台教育频道/平顶山电视台教育/平顶山教育台
朔州新闻综合	duer_0_298	朔州新闻综合/朔州新闻综合频道/朔州一套/朔州一/朔州一台
朔州生活公共	duer_0_299	朔州生活公共/朔州生活公共频道/朔州二套/朔州二/朔州二台
景德镇陶瓷文化	duer_0_300	景德镇陶瓷文化/景德镇电视台陶瓷文化频道/景德镇电视台陶瓷文化/jdztv3/景德镇陶瓷文化台/景德镇三台/景德镇三
景德镇新闻综合	duer_0_301	景德镇新闻综合/景德镇电视台新闻综合频道/景德镇电视台新闻综合/jdztv1/景德镇新闻综合台/景德镇一台/景德镇一
景德镇影视娱乐	duer_0_302	景德镇影视娱乐/景德镇电视台影视娱乐频道/景德镇电视台影视娱乐/jdztv2/景德镇影视娱乐台/景德镇二台/景德镇二
资阳城市频道	duer_0_303	资阳城市频道/资阳城市/资阳电视台城市频道/资阳电视台城市/资阳电视台影视互动频道/资阳电视台影视互动/资阳影视互动频道/资阳影视互动/资阳影视互动台
资阳新农村公共	duer_0_304	资阳新农村公共/资阳电视台新农村公共频道 /资阳电视台新农村公共频道/资阳电视台公共频道/资阳电视台公共/资阳公共频道/资阳公共/资阳公共台
内江新闻综合频道	duer_0_305	内江新闻综合频道/内江新闻综合/内江电视台新闻综合频道/内江电视台新闻综合/内江新闻频道/内江新闻/内江新闻台
广安科教频道	duer_0_306	广安科教频道/广安科教
广安互动娱乐频道	duer_0_307	广安互动娱乐频道/广安互动娱乐
邯郸快乐3频道	duer_0_308	邯郸快乐3频道/邯郸快乐3/邯郸电视台快乐3频道/邯郸电视台快乐3/邯郸公共频道/邯郸公共
丹东信息频道	duer_0_309	丹东信息频道/丹东信息/丹东电视台信息频道/丹东电视台信息/丹东电视台导视频道/丹东电视台导视
舟山群岛旅游台	duer_0_310	舟山群岛旅游台/舟山群岛旅游/舟山电视台群岛旅游频道/舟山电视台群岛旅游/舟山群岛旅游频道
青田台	duer_0_311	青田台/青田/青田电视台/青田电视
睛彩安阳	duer_0_312	睛彩安阳
合肥肥西台	duer_0_313	合肥肥西台/合肥肥西/合肥电视台肥西台/合肥电视台肥西
合肥肥东台	duer_0_314	合肥肥东台/合肥肥东/合肥电视台肥东台/合肥电视台肥东
睛彩黄石	duer_0_315	睛彩黄石/黄石电视台睛彩黄石频道/黄石电视台睛彩黄石
岳阳民生频道	duer_0_316	岳阳民生频道/岳阳民生/岳阳电视台公共民生频道/岳阳电视台公共民生/岳阳电视台公共频道/岳阳电视台公共/岳阳公共频道/岳阳公共/岳阳公共台
张家界都市频道	duer_0_317	张家界都市频道/张家界都市/张家界电视台都市频道/张家界电视台都市/张家界2/张家界二台/张家界二
张家界旅游频道	duer_0_318	张家界旅游频道/张家界旅游/张家界电视台旅游频道/张家界电视台旅游/张家界3/张家界三台/张家界三
朝阳文化娱乐频道	duer_0_319	朝阳文化娱乐频道/朝阳文化娱乐/朝阳电视台文化娱乐频道/朝阳电视台文化娱乐/朝阳广播电视台影视文化频道/朝阳广播电视台影视文化/朝阳影视频道/朝阳影视/朝阳影视台
沣县台	duer_0_320	沣县台/沣县/沣县电视台/沣县电视
桃源台	duer_0_321	桃源台/桃源/桃源电视台/桃源电视
安乡台	duer_0_322	安乡台/安乡/安乡电视台/安乡电视
汉寿台	duer_0_323	汉寿台/汉寿/汉寿电视台/汉寿电视
津市台	duer_0_324	津市台/津市/津市电视台/津市电视
来宾影视频道	duer_0_325	来宾影视频道/来宾影视/来宾电视台影视频道/来宾电视台影视/来宾影视台
吉安二套	duer_0_326	吉安二套/吉安二/吉安电视台二套/吉安电视台二
宜宾城市资讯频道	duer_0_327	宜宾城市资讯频道/宜宾城市资讯
张家港民生频道	duer_0_328	张家港民生频道/张家港民生/张家港电视台民生频道/张家港电视台民生/张家港社会生活
张家港电影	duer_0_329	张家港电影/张家港电视台电影频道/张家港电视台电影
张家港电视剧	duer_0_330	张家港电视剧/张家港电视台电视剧频道/张家港电视台电视剧
南阳图文频道	duer_0_331	南阳图文频道/南阳图文/南阳电视台图文信息频道/南阳电视台图文信息/南阳电视台四套/南阳电视台四/南阳4/nytv4/南阳家庭影院/南阳四套台/南阳四套
开封教育频道	duer_0_332	开封教育频道/开封教育/开封电视台教育频道/开封电视台教育
西宁夏都房车频道	duer_0_333	西宁夏都房车频道/西宁夏都房车/西宁电视台夏都房车频道/西宁电视台夏都房车/夏都房车频道/夏都房车
江阴民生频道	duer_0_334	江阴民生频道/江阴民生/江阴电视台民生频道/江阴电视台民生
宜昌移动频道	duer_0_335	宜昌移动频道/宜昌移动/宜昌电视台移动频道/宜昌电视台移动/宜昌移动台
武进人文	duer_0_336	武进人文/武进电视台人文频道/武进电视台人文
武进娱乐	duer_0_337	武进娱乐/武进电视台娱乐频道/武进电视台娱乐
法治沙头角频道	duer_0_338	法治沙头角频道/法治沙头角/深圳电视台法治沙头角频道/深圳电视台法治沙头角/深视法治频道/深视法治
江西移动频道	duer_0_339	江西移动频道/江西移动/江西电视台移动频道/江西电视台移动/jxtv8/江西移动电视频道/江西移动电视
三明公共频道	duer_0_340	三明公共频道/三明公共/三明电视台公共频道/三明电视台公共/三明2套/三明2/三明2台/三明公共台
三明导视频道	duer_0_341	三明导视频道/三明导视/三明电视台导视频道/三明电视台导视
武进影视	duer_0_342	武进影视/武进影视频道
历城点播台	duer_0_343	历城点播台/历城点播/历城电视台点播频道/历城电视台点播
下周导视	duer_0_344	下周导视/畅享馆导视高清/山东高清导视频道/山东高清导视
天天精选	duer_0_345	天天精选/畅享馆精选高清/山东天天精选频道/山东天天精选/山东高清精选频道/山东高清精选
益阳公共频道	duer_0_346	益阳公共频道/益阳公共/益阳电视台公共频道/益阳电视台公共/益阳公共台
铁路电视	duer_0_347	铁路电视
铁道影视	duer_0_348	铁道影视
第一影视	duer_0_349	第一影视
睛彩三秦	duer_0_350	睛彩三秦
廊坊导视	duer_0_351	廊坊导视
聊城东昌远教	duer_0_352	聊城东昌远教/聊城电视台东昌远教频道/聊城电视台东昌远教/东昌
睛彩岳阳	duer_0_353	睛彩岳阳
湘西综合	duer_0_354	湘西综合/湘西电视台综合频道/湘西电视台综合/湘西综合台/湘西综合频道
湘西公共频道	duer_0_355	湘西公共频道/湘西公共/湘西电视台公共频道/湘西电视台公共/湘西公共台
湘西旅游频道	duer_0_356	湘西旅游频道/湘西旅游/湘西电视台旅游频道/湘西电视台旅游/湘西旅游台
龙山时政	duer_0_357	龙山时政/龙山电视台时政频道/龙山电视台时政/龙山时政台/龙山时政频道
龙山综艺	duer_0_358	龙山综艺/龙山电视台综艺频道/龙山电视台综艺/龙山综艺台/龙山综艺频道
驻马店商务	duer_0_359	驻马店商务/驻马店电视台商务频道/驻马店电视台商务
驻马店娱乐	duer_0_360	驻马店娱乐/驻马店电视台娱乐频道/驻马店电视台娱乐
驻马店图文	duer_0_361	驻马店图文/驻马店电视台图文频道/驻马店电视台图文
电视剧场1	duer_0_362	电视剧场1
电视剧场2	duer_0_363	电视剧场2
广西公共浦北	duer_0_364	广西公共浦北
于洪一套	duer_0_365	于洪一套/于洪一
于洪二套	duer_0_366	于洪二套/于洪二/于洪二台
高唐-1	duer_0_367	高唐1/高唐一台/高唐一
高唐-2	duer_0_368	高唐2/高唐二台/高唐二
高唐党建	duer_0_369	高唐党建
聊城有线导视	duer_0_370	聊城有线导视
浏阳新闻频道	duer_0_371	浏阳新闻频道/浏阳新闻/浏阳电视台新闻频道/浏阳电视台新闻/浏阳新闻台
浏阳经济频道	duer_0_372	浏阳经济频道/浏阳经济/浏阳电视台经济频道/浏阳电视台经济/浏阳经济生活频道/浏阳经济生活/浏阳经济台
浏阳房产频道	duer_0_373	浏阳房产频道/浏阳房产/浏阳电视台房产频道/浏阳电视台房产/浏阳房产台
浏阳商贸频道	duer_0_374	浏阳商贸频道/浏阳商贸/浏阳电视台商贸频道/浏阳电视台商贸/浏阳商贸台
灵石新闻综合	duer_0_375	灵石新闻综合/灵石电视台新闻综合频道/灵石电视台新闻综合/灵石新闻综合台/灵石新闻台/灵石新闻
灵石影视娱乐	duer_0_376	灵石影视娱乐/灵石电视台影视娱乐频道/灵石电视台影视娱乐/灵石影视娱乐台/灵石影视台/灵石影视
灵石经济生活	duer_0_377	灵石经济生活/灵石电视台经济生活频道/灵石电视台经济生活/灵石经济生活台/灵石经济台/灵石经济
湛江信息频道	duer_0_378	湛江信息频道/湛江信息/湛江电视台信息频道/湛江电视台信息
丽水导视	duer_0_379	丽水导视
浙江党建频道	duer_0_380	浙江党建频道/浙江党建/浙江数码时代
什邡新闻综合	duer_0_381	什邡新闻综合/什邡电视台新闻综合
什邡Hi生活	duer_0_382	什邡hi生活/什邡电视台hi生活
慈溪新闻综合	duer_0_383	慈溪新闻综合
慈溪民生休闲	duer_0_384	慈溪民生休闲
慈溪影视图文	duer_0_385	慈溪影视图文
慈溪乡镇频道	duer_0_386	慈溪乡镇频道/慈溪乡镇/慈溪电视台乡镇频道/慈溪电视台乡镇
潍坊图文频道	duer_0_387	潍坊图文频道/潍坊图文/潍坊电视台图文频道/潍坊电视台图文
安丘新闻	duer_0_388	安丘新闻/安丘电视台新闻频道/安丘电视台新闻/安丘新闻频道
安丘民生	duer_0_389	安丘民生/安丘电视台民生频道/安丘电视台民生/安丘民生频道
安丘党建	duer_0_390	安丘党建/安丘党建频道
安丘点播	duer_0_391	安丘点播/安丘点播频道
安丘图文	duer_0_392	安丘图文/安丘图文频道
IPTV3+	duer_0_393	iptv3+/iptv精品综艺
巴州-1	duer_0_394	巴州1/巴州一台/巴州一
巴州-2	duer_0_395	巴州2/巴州二台/巴州二
巴州-3	duer_0_396	巴州3/巴州三台/巴州三
巴州-4	duer_0_397	巴州4/巴州四台/巴州四
巴州-5	duer_0_398	巴州5/巴州五台/巴州五
巴州-6	duer_0_399	巴州6/巴州六台/巴州六
巴州-7	duer_0_400	巴州7/巴州七台/巴州七
巴州-8	duer_0_401	巴州8/巴州八台/巴州八
巴州-9	duer_0_402	巴州9/巴州九台/巴州九
运城导视	duer_0_403	运城导视
抚顺图文频道	duer_0_404	抚顺图文频道/抚顺图文/抚顺电视台图文频道/抚顺电视台图文
昌乐新闻综合频道	duer_0_405	昌乐新闻综合频道/昌乐新闻综合/昌乐电视台新闻综合频道/昌乐电视台新闻综合/昌乐新闻台/昌乐新闻
昌乐影视远教频道	duer_0_406	昌乐影视远教频道/昌乐影视远教/昌乐电视台影视远教频道/昌乐电视台影视远教/昌乐影视台/昌乐影视
昌乐综艺生活频道	duer_0_407	昌乐综艺生活频道/昌乐综艺生活/昌乐电视台综艺生活频道/昌乐电视台综艺生活/昌乐综艺台/昌乐综艺
昌乐图文资讯频道	duer_0_408	昌乐图文资讯频道/昌乐图文资讯/昌乐电视台图文资讯频道/昌乐电视台图文资讯/昌乐图文台/昌乐图文
昌乐农村社区频道	duer_0_409	昌乐农村社区频道/昌乐农村社区/昌乐电视台农村社区频道/昌乐电视台农村社区/昌乐农村台/昌乐农村
睛彩贵州	duer_0_410	睛彩贵州/贵州交通旅游
青海藏语卫视	duer_0_411	青海藏语卫视/安多藏语卫视
睛彩青海	duer_0_412	睛彩青海
信阳教育频道	duer_0_413	信阳教育频道/信阳教育/信阳电视台教育
双鸭山新闻综合	duer_0_414	双鸭山新闻综合/双鸭山电视台新闻综合频道/双鸭山电视台新闻综合/双鸭山新闻台/双鸭山新闻
双鸭山公共频道	duer_0_415	双鸭山公共频道/双鸭山公共/双鸭山电视台公共频道/双鸭山电视台公共/双鸭山公共台
双流45	duer_0_416	双流45
双流空港	duer_0_417	双流空港
双流影视	duer_0_418	双流影视
双流党员教育	duer_0_419	双流党员教育
自贡导视频道	duer_0_420	自贡导视频道/自贡导视/自贡数字电视导视
自贡影视频道	duer_0_421	自贡影视频道/自贡影视/自贡互动影视
自贡娱乐频道	duer_0_422	自贡娱乐频道/自贡娱乐/自贡娱乐台
强县风采	duer_0_423	强县风采
多彩贵州	duer_0_424	多彩贵州/多彩贵州旅游
朝阳教育频道	duer_0_425	朝阳教育频道/朝阳教育
锦州图文信息频道	duer_0_426	锦州图文信息频道/锦州图文信息
锦州有线导视1	duer_0_427	锦州有线导视1
锦州有线导视2	duer_0_428	锦州有线导视2
潜江-1	duer_0_429	潜江1
仙桃一台	duer_0_430	仙桃一台/仙桃一
仙桃二台	duer_0_431	仙桃二台/仙桃二
仙桃三台	duer_0_432	仙桃三台/仙桃三
延安新闻综合频道	duer_0_433	延安新闻综合频道/延安新闻综合/延安电视台新闻综合频道/延安电视台新闻综合/延安电视台1套/延安电视台1
延安影视娱乐频道	duer_0_434	延安影视娱乐频道/延安影视娱乐/延安电视台影视娱乐频道/延安电视台影视娱乐/延安电视台2套/延安电视台2
平顶山图文信息	duer_0_435	平顶山图文信息
平顶山睛彩	duer_0_436	平顶山睛彩
中国平煤神马综合	duer_0_437	中国平煤神马综合/平顶山平煤综合
中国平煤神马安全	duer_0_438	中国平煤神马安全/平顶山平煤安全
泸州公共频道	duer_0_439	泸州公共频道/泸州公共/泸州电视台公共频道/泸州电视台公共/泸州2/泸州公共台/泸州二台/泸州二
泸州资讯频道	duer_0_440	泸州资讯频道/泸州资讯/泸州电视台资讯频道/泸州电视台资讯
泸州新农村频道	duer_0_441	泸州新农村频道/泸州新农村/泸州电视台互动新农村频道/泸州电视台互动新农村/泸州互动新农村频道/泸州互动新农村
健康咨询	duer_0_442	健康咨询/山东电视台健康咨询频道/山东电视台健康咨询
临沂快乐7	duer_0_443	临沂快乐7/临沂电视台快乐七频道/临沂电视台快乐七
益阳导视频道	duer_0_444	益阳导视频道/益阳导视
夷陵综合频道	duer_0_445	夷陵综合频道/夷陵综合/夷陵电视台综合频道/夷陵电视台综合/yltv1/夷陵综合台
夷陵影视频道	duer_0_446	夷陵影视频道/夷陵影视/夷陵电视台影视频道/夷陵电视台影视/yltv2/夷陵影视台
资讯频道	duer_0_447	资讯频道/资讯/安广资讯/数字展播频道/数字展播/数字服务频道/数字服务/资讯导视/信息资讯/房产汽车/服务指南/数字电视小知识/内容提示/数字电台/数字电/网络图文信息/华数频道/华数/常熟便民服务/吉大电视/资讯服务/数字红河/数字电视咨询/信息/生活资讯1/生活资讯2/从化资讯/图文信息/宜都资讯服务/资讯新干线/数字视界/通州数字电视宣传/资讯本地文化/嘉兴资讯/生活资讯/视事通服务/用户指南/图文电视/本地资讯/都市生活/楚天
互动频道	duer_0_448	互动频道/互动/安广互动/互动生活/互动资讯/健康科普/互动电视
桐城新闻频道	duer_0_449	桐城新闻频道/桐城新闻/桐城新闻台
桐城影视频道	duer_0_450	桐城影视频道/桐城影视/桐城影视台
桐城生活频道	duer_0_451	桐城生活频道/桐城生活/桐城生活台
测试频道1	duer_0_452	测试频道1/试播频道一/专用频道1/标清测试1/高清测试1/专业频道1
测试频道2	duer_0_453	测试频道2/试播频道二/专用频道2/标清测试2/高清测试2/专业频道2
吕梁新闻综合	duer_0_454	吕梁新闻综合/吕梁电视台新闻综合频道/吕梁电视台新闻综合/吕梁1/吕梁一台/吕梁一
交口综合频道	duer_0_455	交口综合频道/交口综合/交口1/交口一台/交口一
交口经济频道	duer_0_456	交口经济频道/交口经济/交口2/交口二台/交口二
内蒙中小企业台	duer_0_457	内蒙中小企业台/内蒙中小企业/内蒙古中小企业频道/内蒙古中小企业
深圳龙岗频道	duer_0_458	深圳龙岗频道/深圳龙岗/龙岗一套/龙岗一/龙岗一台
深圳东部频道	duer_0_459	深圳东部频道/深圳东部
深圳宝安频道	duer_0_460	深圳宝安频道/深圳宝安/宝安一套/宝安一/宝安一台
深圳西部频道	duer_0_461	深圳西部频道/深圳西部
宜城综合	duer_0_462	宜城综合
宜城农业	duer_0_463	宜城农业
宜城都市	duer_0_464	宜城都市
宜城影视	duer_0_465	宜城影视
测试频道3	duer_0_466	测试频道3/专用频道3/标清测试3/高清测试3/专业频道3
测试频道4	duer_0_467	测试频道4/专用频道4/标清测试4/高清测试4/专业频道4
测试频道5	duer_0_468	测试频道5/专用频道5/标清测试5/高清测试5/专业频道5
测试频道6	duer_0_469	测试频道6/专用频道6/标清测试6/高清测试6/专业频道6
体验频道1	duer_0_470	体验频道1/试看频道 一/赠送1/内部测试1/高清预留频道1/常熟试播1/免费体验1/广电轮播64频道/广电轮播64/东方悦居/导视1/乐宅院线1/检测1/视频epg1/预留频道1/社区服务/导视体验频道1/高清体验a1/展播频道1
体验频道2	duer_0_471	体验频道2/高清体验a2/试看频道 二/赠送2/内部测试2/高清预留频道2/付费体验2/常熟试播2/免费体验2/广电轮播100频道/广电轮播100/东方尚品/导视2/乐宅院线2/检测2/视频epg2/预留频道2/最新推荐/导视体验频道2/展播频道2
体验频道3	duer_0_472	体验频道3/高清体验a3/赠送3/高清预留频道3/公益信息/免费体验3/东方食味/投票调查/导视3/检测3/视频epg3/导视体验频道3/展播频道3/预留频道3
体验频道4	duer_0_473	体验频道4/高清体验a4/赠送4/高清预留频道4/神宝tv/免费体验4/导视4/视频epg4/走进壹tv/预留频道4
体验频道5	duer_0_474	体验频道5/高清体验a5/赠送5/互联网视频/视频epg5/预留频道5
高清体验1	duer_0_475	高清体验1/自办高清/赠送6/中央新闻回放/高清测试频道1
高清体验2	duer_0_476	高清体验2/赠送7/广西新闻回放/自办高清2/高清测试频道2/红盾在线
高清体验3	duer_0_477	高清体验3/高清测试频道3/社会新闻回放/自办高清3
高清体验4	duer_0_478	高清体验4/高清测试频道4/自办高清4/魅力高清
高清体验5	duer_0_479	高清体验5/高清测试频道5/宽带指南
淄博图文	duer_0_480	淄博图文
张店台	duer_0_481	张店台/张店
测试频道	duer_0_482	测试频道/测试/备用频道/备用/cctv测试/应急广播/系统测试/未命名节目/测试预留/标清测试/高清测试/测试01/内部电视台/内部电视/预留频道/预留
新都综合频道	duer_0_483	新都综合频道/新都综合
新都影视文艺频道	duer_0_484	新都影视文艺频道/新都影视文艺
党员教育	duer_0_485	党员教育/党干远程教育/农村党员教育/郫县党员远教/远程教育/延安党员教育
DTV导视	duer_0_486	dtv导视/河南有线导视
滁州新闻综合	duer_0_487	滁州新闻综合/滁州电视台新闻综合频道/滁州电视台新闻综合/滁州综合频道/滁州综合
滁州公共频道	duer_0_488	滁州公共频道/滁州公共/滁州电视台公共频道/滁州电视台公共/滁州公共台
滁州科教频道	duer_0_489	滁州科教频道/滁州科教/滁州电视台科教频道/滁州电视台科教/滁州科教台
滁州文产频道	duer_0_490	滁州文产频道/滁州文产/滁州电视台文产频道/滁州电视台文产/滁州文产台
区县频道	duer_0_491	区县频道/区县/南谯新闻综合/盐湖电视/澄海台/澄海/益阳赫山频道/益阳赫山/肃州区一套/肃州区一/海西电视/南票区有线/城区电视台/城区电视/县市频道/县市/六盘水三套/六盘水三/集安电视台1套/集安电视台1/泰山有线/磐石电视台/磐石电视/宜信台/宜信/公共频道塘桥/蒲江电视1套/蒲江电视1/雨城/朝阳有线图文/隆化1/新津新闻综合/武侯政务/户县1/区市频道/区市/凤翔综合频道/凤翔综合/濮阳县/罗定/榆树/南安一套/南安一/红兴隆新闻综合/牡丹区一套/牡丹区一/金牛有线/准格尔电视台/准格尔电视/成华有线/本县市节目/东港新闻/
贵州7频道	duer_0_492	贵州7频道/贵州7
测试频道7	duer_0_493	测试频道7/专用频道7/标清测试7/高清测试7/专业频道7
测试频道8	duer_0_494	测试频道8/标清测试8/专用频道8/高清测试8
测试频道9	duer_0_495	测试频道9/测试节目9/标清测试9/专用频道9/高清测试9
贵阳远程教育	duer_0_496	贵阳远程教育
铜仁远程教育	duer_0_497	铜仁远程教育/贵州远程教育
小学一年级	duer_0_498	小学一年级/教育频道2/自学引擎1/一年级
小学二年级	duer_0_499	小学二年级/教育频道3/自学引擎2/二年级
小学三年级	duer_0_500	小学三年级/教育频道4/自学引擎3/三年级
小学四年级	duer_0_501	小学四年级/教育频道5/自学引擎4/四年级
小学五年级	duer_0_502	小学五年级/教育频道6/自学引擎5/五年级
小学六年级	duer_0_503	小学六年级/教育频道7/自学引擎6/六年级
语文专题辅导	duer_0_504	语文专题辅导/自学引擎7/中考辅导语文
数学专题辅导	duer_0_505	数学专题辅导/中考辅导数学/自学引擎8
日照港台	duer_0_506	日照港台/日照港
洪泽新闻综合频道	duer_0_507	洪泽新闻综合频道/洪泽新闻综合/洪泽电视台新闻综合频道/洪泽电视台新闻综合/洪泽一套/洪泽一/洪泽一台
洪泽综艺频道	duer_0_508	洪泽综艺频道/洪泽综艺/洪泽电视台综艺频道/洪泽电视台综艺/洪泽二套/洪泽二/洪泽二台
洪泽影视频道	duer_0_509	洪泽影视频道/洪泽影视/洪泽电视台影视频道/洪泽电视台影视/洪泽三套/洪泽三/洪泽三台
洪泽四套	duer_0_510	洪泽四套/洪泽四/洪泽四台
洪泽生活	duer_0_511	洪泽生活/洪泽生活频道/洪泽生活台
铜川新闻综合	duer_0_512	铜川新闻综合/铜川电视台新闻综合频道/铜川电视台新闻综合/铜川一台/铜川一/铜川新闻台/铜川新闻
铜川文化娱乐	duer_0_513	铜川文化娱乐/铜川电视台文化娱乐频道/铜川电视台文化娱乐/铜川二台/铜川二/铜川文化台/铜川文化
QTV-城阳	duer_0_514	qtv城阳
QTV-崂山	duer_0_515	qtv崂山
运城图文频道	duer_0_516	运城图文频道/运城图文/运城电视台图文频道/运城电视台图文
坪山资讯频道	duer_0_517	坪山资讯频道/坪山资讯/坪山资讯台
光明新区资讯	duer_0_518	光明新区资讯/光明新区资讯频道
南山资讯频道	duer_0_519	南山资讯频道/南山资讯
华数服务	duer_0_520	华数服务/华数0频道/华数0
港台剧场	duer_0_521	港台剧场/华数港台剧场
男人剧场	duer_0_522	男人剧场/华数男人剧场
风尚生活	duer_0_523	风尚生活
戏曲联播	duer_0_524	戏曲联播/戏曲连播
偶像剧场	duer_0_525	偶像剧场/华数偶像剧场
肥城-1	duer_0_526	肥城1/肥城一台/肥城一
肥城-2	duer_0_527	肥城2/肥城二台/肥城二
肥城生活	duer_0_528	肥城生活
肥城党建文明	duer_0_529	肥城党建文明/肥城党建文明频道
上饶移动电视	duer_0_530	上饶移动电视/中国移动特约/网络电话点播/网络电话点歌/长客电视
SRTV-3	duer_0_531	srtv3
SRTV-4	duer_0_532	srtv4
SRTV-5	duer_0_533	srtv5
热映经典	duer_0_534	热映经典
经典剧场	duer_0_535	经典剧场
江西同步剧场	duer_0_536	江西同步剧场
韩剧专场	duer_0_537	韩剧专场/江西韩剧专场
先锋剧场	duer_0_538	先锋剧场
新乡信息互动	duer_0_539	新乡信息互动
新乡城市频道	duer_0_540	新乡城市频道/新乡城市/新乡城市台
安化综合频道	duer_0_541	安化综合频道/安化综合/安化电视台综合频道/安化电视台综合/安化综合台
安化电视剧频道	duer_0_542	安化电视剧频道/安化电视剧/安化电视台电视剧频道/安化电视台电视剧/安化电视剧台
安化电影图文频道	duer_0_543	安化电影图文频道/安化电影图文/安化电视台电影图文频道/安化电视台电影图文/安化电影图文台
睛彩天下频道	duer_0_544	睛彩天下频道/睛彩天下/精彩天下
测试频道10	duer_0_545	测试频道10/标清测试10/专用频道10
睛彩酒泉	duer_0_546	睛彩酒泉
甘肃导视	duer_0_547	甘肃导视
兰州导视	duer_0_548	兰州导视
高清美食健康	duer_0_549	高清美食健康
高清环球电影	duer_0_550	高清环球电影
湖州阿通频道	duer_0_551	湖州阿通频道/湖州阿通/湖州电视台阿通信息频道/湖州电视台阿通信息/阿通频道/阿通/湖州阿通台
集团频道	duer_0_552	集团频道/集团/青海油田/南煤电视/兖矿频道/兖矿/准能电视/石化有线/吉化有线一套/吉化有线一/管道电视
通化新闻综合	duer_0_553	通化新闻综合/通化电视台新闻综合频道/通化电视台新闻综合/通化新闻台/通化新闻
通化科教频道	duer_0_554	通化科教频道/通化科教/通化电视台科教频道/通化电视台科教/通化科教台
通化公共频道	duer_0_555	通化公共频道/通化公共/通化电视台公共频道/通化电视台公共/通化公共台
区县频道2	duer_0_556	区县频道2/郊区电视台/郊区电视/县（市）频道2/集安电视台2套/集安电视台2/岱岳有线/磐石影视频道/磐石影视/蒲江电视2套/蒲江电视2/隆化2/新津影视文艺/户县2/区市频道2/凤翔文化影视/江北台/江北/榆树有线/南安二套/南安二/牡丹区二套/牡丹区二/dntv2/社区频道1/陈巴尔虎/崇州2台/崇州2/龙泉影视文艺/邛崃电视2台/邛崃电视2/通城二套/通城二/太湖影视文艺/栖霞二套/栖霞二/青海文化/阎良2/长安2/利津生活频道/利津生活/六合影视生活/垫江综艺/中江影视文娱/邵阳县影视/綦江生活/
长治科教法制频道	duer_0_557	长治科教法制频道/长治科教法制/长治电视台科教法制频道/长治电视台科教法制/长治tv4/长治教育频道/长治教育/长治四台/长治四/长治教育台
六盘水新闻综合	duer_0_558	六盘水新闻综合/六盘水电视台新闻综合频道/六盘水电视台新闻综合/六盘水一套/六盘水一/六盘水一台
六盘水公共频道	duer_0_559	六盘水公共频道/六盘水公共/六盘水电视台公共频道/六盘水电视台公共/六盘水二套/六盘水二/六盘水二台
寿阳新闻	duer_0_560	寿阳新闻/寿阳电视台新闻频道/寿阳电视台新闻/寿阳新闻台/寿阳新闻频道
寿阳综合	duer_0_561	寿阳综合/寿阳电视台综合频道/寿阳电视台综合/寿阳综合台/寿阳综合频道
寿阳创业科教	duer_0_562	寿阳创业科教/寿阳电视台创业科教频道/寿阳电视台创业科教/寿阳创业科教台/寿阳创业频道/寿阳创业
绵竹新闻综合	duer_0_563	绵竹新闻综合/绵竹电视台新闻综合频道/绵竹电视台新闻综合
绵竹影视文艺	duer_0_564	绵竹影视文艺/绵竹电视台影视文艺频道/绵竹电视台影视文艺
绵竹三台	duer_0_565	绵竹三台/绵竹三
区县频道3	duer_0_566	区县频道3/蒲江电视3套/蒲江电视3/榆树综艺/崇州3台/崇州3/邛崃电视3套/邛崃电视3/通城三套/通城三/太湖经济生活/阎良3/长安3/利津综艺频道/利津综艺/郫县3/綦江影视/沙河影视娱乐
宁海新闻综合频道	duer_0_567	宁海新闻综合频道/宁海新闻综合/宁海电视台新闻综合频道/宁海电视台新闻综合/宁海新闻综合台
宁海文化生活频道	duer_0_568	宁海文化生活频道/宁海文化生活/宁海电视台文化生活频道/宁海电视台文化生活/宁海文化生活台
宁海图文资讯频道	duer_0_569	宁海图文资讯频道/宁海图文资讯/宁海电视台图文资讯频道/宁海电视台图文资讯/宁海图文资讯台
宁波教育在线	duer_0_570	宁波教育在线/宁波教育在线频道/nbtv教育在线/nbtv6教育科技频道/nbtv6教育科技/宁波教育科技/nbtv教育科技
文化信息共享	duer_0_571	文化信息共享
烟台图文频道	duer_0_572	烟台图文频道/烟台图文/烟台电视台图文频道/烟台电视台图文
体验频道	duer_0_573	体验频道/体验/高清试看/试验频道/试验/体验节目/免费体验/标清付费频道/标清付费/展播频道/展播/旅游897
湘潭商务频道	duer_0_574	湘潭商务频道/湘潭商务/湘潭电视台商务/湘潭商务台
科学生活频道	duer_0_575	科学生活频道/科学生活/湖南科学生活频道/湖南科学生活
财富剧场频道	duer_0_576	财富剧场频道/财富剧场/湖南电视台财富剧场频道/湖南电视台财富剧场/湖南财富剧场
朝阳台	duer_0_577	朝阳台/朝阳
海淀台	duer_0_578	海淀台/海淀
丰台台	duer_0_579	丰台台/丰台
石景山台	duer_0_580	石景山台/石景山
北仑商务休闲频道	duer_0_581	北仑商务休闲频道/北仑商务休闲/北仑电视台商务休闲频道/北仑电视台商务休闲/北仑商务休闲台
北仑图文信息频道	duer_0_582	北仑图文信息频道/北仑图文信息/北仑电视台图文信息频道/北仑电视台图文信息/北仑图文信息台
甜果高清剧场	duer_0_583	甜果高清剧场
峄城台	duer_0_584	峄城台/峄城
高新区台	duer_0_585	高新区台/高新区
枣矿台	duer_0_586	枣矿台/枣矿/枣矿新中兴
德州都市频道	duer_0_587	德州都市频道/德州都市/德州电视台时尚频道/德州电视台时尚/德州时尚频道/德州时尚/德州都市台
齐河新闻频道	duer_0_588	齐河新闻频道/齐河新闻/齐河电视台新闻频道/齐河电视台新闻/齐河新闻台
齐河经济频道	duer_0_589	齐河经济频道/齐河经济/齐河电视台经济频道/齐河电视台经济/齐河经济台
齐河党建频道	duer_0_590	齐河党建频道/齐河党建/齐河电视台党建频道/齐河电视台党建/齐河党建台
齐河生活频道	duer_0_591	齐河生活频道/齐河生活/齐河电视台生活频道/齐河电视台生活/齐河生活台
齐河影视频道	duer_0_592	齐河影视频道/齐河影视/齐河电视台影视频道/齐河电视台影视/齐河影视台
齐河图文频道	duer_0_593	齐河图文频道/齐河图文/齐河电视台图文频道/齐河电视台图文/齐河图文台
齐河娱乐频道	duer_0_594	齐河娱乐频道/齐河娱乐/齐河电视台娱乐频道/齐河电视台娱乐/齐河娱乐台
集团频道2	duer_0_595	集团频道2/济南铁路/铁道频道/铁道
电视会议1	duer_0_596	电视会议1/电视会议/会议电视1hd/高清会议电视1/会议高清
教育频道	duer_0_597	教育频道/教育/婴幼儿教育/教育学堂/金陵文教/教育频道1
测试频道11	duer_0_598	测试频道11/标清测试11/专用频道11
测试频道13	duer_0_599	测试频道13
测试频道12	duer_0_600	测试频道12
测试频道14	duer_0_601	测试频道14
测试频道15	duer_0_602	测试频道15
测试频道16	duer_0_603	测试频道16
测试频道17	duer_0_604	测试频道17
测试频道18	duer_0_605	测试频道18
测试频道19	duer_0_606	测试频道19
邹平综合频道	duer_0_607	邹平综合频道/邹平综合/邹平电视台综合频道/邹平电视台综合/邹平新闻频道/邹平新闻/邹平综合台
邹平经济频道	duer_0_608	邹平经济频道/邹平经济/邹平电视台经济频道/邹平电视台经济/邹平民生频道/邹平民生/邹平经济台
邹平综艺	duer_0_609	邹平综艺/邹平电视台综艺频道/邹平电视台综艺
邹平西王	duer_0_610	邹平西王/邹平电视台西王频道/邹平电视台西王
邹平远教	duer_0_611	邹平远教/邹平电视台远程教育频道/邹平电视台远程教育/邹平远程教育
财富生活频道	duer_0_612	财富生活频道/财富生活
吴江图文频道	duer_0_613	吴江图文频道/吴江图文/吴江电视台图文频道/吴江电视台图文/吴江图文台
昌邑综合	duer_0_614	昌邑综合/昌邑电视台综合频道/昌邑电视台综合
昌邑生活	duer_0_615	昌邑生活/昌邑电视台生活频道/昌邑电视台生活
昌邑棉纺城	duer_0_616	昌邑棉纺城/昌邑电视台棉纺城频道/昌邑电视台棉纺城
昌邑商务	duer_0_617	昌邑商务/昌邑电视台商务频道/昌邑电视台商务
昌邑图文	duer_0_618	昌邑图文/昌邑电视台图文频道/昌邑电视台图文
昌邑远教	duer_0_619	昌邑远教/昌邑电视台远教频道/昌邑电视台远教
汉川新闻综合	duer_0_620	汉川新闻综合/汉川电视台新闻综合频道/汉川电视台新闻综合/汉川综合/汉川综合台/汉川综合频道
汉川生活频道	duer_0_621	汉川生活频道/汉川生活/汉川电视台生活资讯频道/汉川电视台生活资讯/汉川影视/汉川影视台/汉川影视频道
汉川党建农业	duer_0_622	汉川党建农业/汉川电视台党建农业频道/汉川电视台党建农业/农村科教/汉川农村科教台/汉川农村科教/汉川农村科教频道
云浮综合频道	duer_0_623	云浮综合频道/云浮综合/云浮电视台综合频道/云浮电视台综合/云浮综合台
云浮公共频道	duer_0_624	云浮公共频道/云浮公共/云浮电视台公共频道/云浮电视台公共/云浮公共台
白城新闻综合	duer_0_625	白城新闻综合/白城电视台新闻综合频道/白城电视台新闻综合/白城1/白城一台/白城一
白城娱乐频道	duer_0_626	白城娱乐频道/白城娱乐/白城电视台娱乐频道/白城电视台娱乐/白城二套/白城二/白城二台
白城公共频道	duer_0_627	白城公共频道/白城公共/白城电视台公共频道/白城电视台公共/白城三套/白城三/白城三台/白城公共台
白城四套	duer_0_628	白城四套/白城四/白城4/白城四台
鹤壁教育频道	duer_0_629	鹤壁教育频道/鹤壁教育/鹤壁教育台
鹤壁导视	duer_0_630	鹤壁导视/鹤壁数字导视频道/鹤壁数字导视
宁波互动生活	duer_0_631	宁波互动生活/宁波电视台互动生活频道/宁波电视台互动生活
美丽云南	duer_0_632	美丽云南/美丽云南彩云导视
精品荟萃	duer_0_633	精品荟萃/精品荟萃彩云导视
QTV-黄岛	duer_0_634	qtv黄岛
牟平综合频道	duer_0_635	牟平综合频道/牟平综合/牟平电视台综合频道/牟平电视台综合
牟平生活频道	duer_0_636	牟平生活频道/牟平生活/牟平电视台生活频道/牟平电视台生活
牟平资讯频道	duer_0_637	牟平资讯频道/牟平资讯/牟平电视台资讯频道/牟平电视台资讯
邹城党建	duer_0_638	邹城党建
丰润1台	duer_0_639	丰润1台/丰润1
丰润2台	duer_0_640	丰润2台/丰润2
丰润3台	duer_0_641	丰润3台/丰润3
丰润4台	duer_0_642	丰润4台/丰润4
曲靖-1	duer_0_643	曲靖1/曲靖一台/曲靖一
曲靖-2	duer_0_644	曲靖2/曲靖二台/曲靖二
曲靖-3	duer_0_645	曲靖3/曲靖三台/曲靖三
辽源新闻频道	duer_0_646	辽源新闻频道/辽源新闻/辽源电视台新闻综合频道/辽源电视台新闻综合/辽源新闻台
辽源公共频道	duer_0_647	辽源公共频道/辽源公共/辽源电视台公共频道/辽源电视台公共/辽源公共台
曙光农场1	duer_0_648	曙光农场1
曙光农场2	duer_0_649	曙光农场2
曙光农场3	duer_0_650	曙光农场3
曙光农场4	duer_0_651	曙光农场4
太仓生活频道	duer_0_652	太仓生活频道/太仓生活/太仓电视台生活频道/太仓电视台生活/娄东民生/太仓生活台
太仓人文频道	duer_0_653	太仓人文频道/太仓人文/太仓电视台人文频道/太仓电视台人文/扬帆生活/太仓人文台
太仓财经资讯频道	duer_0_654	太仓财经资讯频道/太仓财经资讯/太仓电视台财经资讯频道/太仓电视台财经资讯/太仓财经资讯台
太仓影视娱乐频道	duer_0_655	太仓影视娱乐频道/太仓影视娱乐/太仓电视台影视娱乐频道/太仓电视台影视娱乐/太仓影视娱乐台
太仓党建频道	duer_0_656	太仓党建频道/太仓党建/太仓电视台党建频道/太仓电视台党建/太仓党建台
菏泽图文频道	duer_0_657	菏泽图文频道/菏泽图文/菏泽电视台图文频道/菏泽电视台图文/菏泽图文台
义乌图文频道	duer_0_658	义乌图文频道/义乌图文/义乌电视台图文频道/义乌电视台图文/义乌图文信息/义乌图文信息频道
新视界	duer_0_659	新视界
内江科教频道	duer_0_660	内江科教频道/内江科教/内江科教台
红河新闻综合	duer_0_661	红河新闻综合/红河电视台新闻综合频道/红河电视台新闻综合/红河台1新闻综合/红河台一台新闻综合
红河经济生活	duer_0_662	红河经济生活/红河经济生活频道/红河台2经济生活
红河民族文化	duer_0_663	红河民族文化/红河电视台民族文化频道/红河电视台民族文化/红河台3民族文化
红河社会与法	duer_0_664	红河社会与法/红河电视台社会与法频道/红河电视台社会与法/红河台4社会与法
莱西综合	duer_0_665	莱西综合/莱西电视台综合频道/莱西电视台综合/莱西综合台
莱西生活	duer_0_666	莱西生活/莱西电视台生活频道/莱西电视台生活/莱西生活台
莱西农经	duer_0_667	莱西农经/莱西电视台农经频道/莱西电视台农经/莱西农经台
攀枝花公共频道	duer_0_668	攀枝花公共频道/攀枝花公共/攀枝花电视台公共频道/攀枝花电视台公共/攀枝花公共台
攀枝花影视文艺	duer_0_669	攀枝花影视文艺
集团频道3	duer_0_670	集团频道3/宁铁有线/哈铁有线
电视会议2	duer_0_671	电视会议2/会议电视2hd/高清会议电视2
电视会议3	duer_0_672	电视会议3/会议电视3hd/高清会议电视3
大兴安岭新闻	duer_0_673	大兴安岭新闻/大兴安岭新闻频道/大兴安岭新闻台
大兴安岭公共	duer_0_674	大兴安岭公共/大兴安岭公共频道/大兴安岭公共台
睛彩宁夏	duer_0_675	睛彩宁夏
宁夏教育	duer_0_676	宁夏教育/宁夏电视台教育频道/宁夏电视台教育
松滋公共	duer_0_677	松滋公共/松滋电视台公共频道/松滋电视台公共/松滋公共台
松滋综合	duer_0_678	松滋综合/松滋电视台新闻综合频道/松滋电视台新闻综合/松滋综合台
松滋文艺	duer_0_679	松滋文艺/松滋电视频道文艺频道/松滋电视频道文艺/松滋文艺台
松滋影视	duer_0_680	松滋影视/松滋电视台影视频道/松滋电视台影视/松滋影视台
睛彩·新华	duer_0_681	睛彩·新华
DRA5I经典	duer_0_682	dra5i经典/dra5ijd/51经典/5i经典
DRA5I流行	duer_0_683	dra5i流行/51流行/5i流行
高清演示	duer_0_684	高清演示
广州公共频道	duer_0_685	广州公共频道/广州公共/广州电视台公共频道/广州电视台公共/公共台/公共/广州公共台
增城台	duer_0_686	增城台/增城
数字电视频道	duer_0_687	数字电视频道/数字电视/电视导航/3g业务上市发布/资讯广场/江苏老年
点播频道	duer_0_688	点播频道/点播/龙视院线/精彩点播/绍兴新闻点播/江阴点歌
花都频道	duer_0_689	花都频道/花都
广州电视	duer_0_690	广州电视
健康频道	duer_0_691	健康频道/健康/健康养生
企业新闻	duer_0_692	企业新闻/企业风采/魅力江苏
宜信图文台	duer_0_693	宜信图文台/宜信图文
旅行频道	duer_0_694	旅行频道/旅行/旅行天地/休闲旅游
科学探索	duer_0_695	科学探索
宜和西部频道	duer_0_696	宜和西部频道/宜和西部
深圳气象频道	duer_0_697	深圳气象频道/深圳气象
蛇口导视频道	duer_0_698	蛇口导视频道/蛇口导视
动画频道	duer_0_699	动画频道/动画
深沪股票	duer_0_700	深沪股票
惠州综合	duer_0_701	惠州综合
中山信息频道	duer_0_702	中山信息频道/中山信息/中山公共信息频道/中山公共信息
东莞影院	duer_0_703	东莞影院
股票市场	duer_0_704	股票市场/股市/股市在线/股票信息/股市财经
江苏视频频道	duer_0_705	江苏视频频道/江苏视频
荆州公共频道	duer_0_706	荆州公共频道/荆州公共
成都电影频道	duer_0_707	成都电影频道/成都电影
江宁信息频道	duer_0_708	江宁信息频道/江宁信息/江宁信息台
游戏频道	duer_0_709	游戏频道/游戏/云游戏/电视游戏
政务频道	duer_0_710	政务频道/政务/阳光政务/便民三务信息
邯郸电视剧频道	duer_0_711	邯郸电视剧频道/邯郸电视剧/邯郸电视台电视剧频道/邯郸电视台电视剧
通州新闻综合	duer_0_712	通州新闻综合/通州电视台新闻综合/通州新闻台/通州新闻
通州电视剧	duer_0_713	通州电视剧/通州电视台电视剧频道/通州电视台电视剧/通州电视剧台
通州电影	duer_0_714	通州电影/通州电视台电影频道/通州电视台电影/通州电影台
通州文艺生活	duer_0_715	通州文艺生活/通州文艺台/通州文艺
镇海信息频道	duer_0_716	镇海信息频道/镇海信息
镇海炼化台	duer_0_717	镇海炼化台/镇海炼化
睛彩晋城	duer_0_718	睛彩晋城
湖南导视频道	duer_0_719	湖南导视频道/湖南导视
长兴家庭频道	duer_0_720	长兴家庭频道/长兴家庭/长兴家庭台
长兴图文频道	duer_0_721	长兴图文频道/长兴图文/长兴图文台
即墨新闻频道	duer_0_722	即墨新闻频道/即墨新闻/即墨电视台新闻综合频道/即墨电视台新闻综合/即墨新闻台
即墨生活频道	duer_0_723	即墨生活频道/即墨生活/即墨电视台生活服务频道/即墨电视台生活服务/即墨生活台
即墨综艺频道	duer_0_724	即墨综艺频道/即墨综艺/即墨电视台综艺影视频道/即墨电视台综艺影视/即墨综艺台
QTV-图闻	duer_0_725	qtv图闻/青岛图文台/青岛图文
莱西影视	duer_0_726	莱西影视/莱西电视台影视频道/莱西电视台影视/莱西影视台
新闻荟萃频道	duer_0_727	新闻荟萃频道/新闻荟萃
南平公共影视	duer_0_728	南平公共影视/南平电视台公共影视频道/南平电视台公共影视
旅顺1台	duer_0_729	旅顺1台/旅顺1/大连旅顺1台/大连旅顺1
旅顺2台	duer_0_730	旅顺2台/旅顺2/大连旅顺2台/大连旅顺2
旅顺3台	duer_0_731	旅顺3台/旅顺3/大连旅顺3台/大连旅顺3
天途高清影院	duer_0_732	天途高清影院
天途高清剧场	duer_0_733	天途高清剧场
高清少儿	duer_0_734	高清少儿/天途高清少儿
定州影视	duer_0_735	定州影视/定州电视台影视频道/定州电视台影视
石河子综合	duer_0_736	石河子综合/石河子电视台综合频道/石河子电视台综合/石河子综合台
石河子经济生活	duer_0_737	石河子经济生活/石河子电视台经济生活频道/石河子电视台经济生活/石河子经济台/石河子经济
石河子影视文体	duer_0_738	石河子影视文体/石河子电视台影视文体频道/石河子电视台影视文体/石河子影视台/石河子影视
石河子教育	duer_0_739	石河子教育/石河子教育台
昌图一套	duer_0_740	昌图一套/昌图一/昌图1/昌图一台
昌图二套	duer_0_741	昌图二套/昌图二/昌图2/昌图二台
昌图三套	duer_0_742	昌图三套/昌图三/昌图3/昌图三台
睛彩江城	duer_0_743	睛彩江城
坊子综合	duer_0_744	坊子综合
坊子生活	duer_0_745	坊子生活
坊子点播	duer_0_746	坊子点播
青州新闻综合	duer_0_747	青州新闻综合/青州电视台新闻综合频道/青州电视台新闻综合
青州经济生活	duer_0_748	青州经济生活/青州电视台经济生活频道/青州电视台经济生活
青州文化旅游花卉	duer_0_749	青州文化旅游花卉/青州电视台文化旅游花卉频道/青州电视台文化旅游花卉
青州影视	duer_0_750	青州影视/青州电视台影视频道/青州电视台影视
晋江体育频道	duer_0_751	晋江体育频道/晋江体育/晋江电视台体育频道/晋江电视台体育
星空移动频道	duer_0_752	星空移动频道/星空移动
济宁导视频道	duer_0_753	济宁导视频道/济宁导视/济宁电视台导视频道/济宁电视台导视
滨海新闻频道	duer_0_754	滨海新闻频道/滨海新闻/滨海新闻台
滨海经济频道	duer_0_755	滨海经济频道/滨海经济/滨海生活频道/滨海生活/滨海生活台/滨海经济台
滨海影视频道	duer_0_756	滨海影视频道/滨海影视/滨海影视台
滨海城市频道	duer_0_757	滨海城市频道/滨海城市/滨海快乐频道/滨海快乐/滨海城市台
滨海第一资讯	duer_0_758	滨海第一资讯
辽中时政	duer_0_759	辽中时政/辽中电视台时政频道/辽中电视台时政
辽中综艺	duer_0_760	辽中综艺/辽中电视台综艺频道/辽中电视台综艺
辽中图文	duer_0_761	辽中图文/辽中电视台图文频道/辽中电视台图文
辽中数字电视	duer_0_762	辽中数字电视
沈阳图文	duer_0_763	沈阳图文
平山综合	duer_0_764	平山综合/平山电视台综合频道/平山电视台综合
平山影视	duer_0_765	平山影视/平山电视台影视频道/平山电视台影视
麦积电视台	duer_0_766	麦积电视台/麦积电视
绍兴商务电视	duer_0_767	绍兴商务电视/绍兴商务电视台商务电视频道/绍兴商务电视台商务电视
绍兴有线信息	duer_0_768	绍兴有线信息/绍兴商务电视台有线信息频道/绍兴商务电视台有线信息
绍兴有线娱乐	duer_0_769	绍兴有线娱乐/绍兴商务电视台有线娱乐频道/绍兴商务电视台有线娱乐
精品影院频道	duer_0_770	精品影院频道/精品影院/精品影院nvod
亚洲影院频道	duer_0_771	亚洲影院频道/亚洲影院/亚洲影院nvod
欧美影院频道	duer_0_772	欧美影院频道/欧美影院/欧美影院nvod
动漫科幻影院	duer_0_773	动漫科幻影院/动漫科幻影院频道/动漫影院频道/动漫影院/动漫科幻影院nvod
现代剧场	duer_0_774	现代剧场/现代剧场频道/现代剧场nvod
韩剧剧场	duer_0_775	韩剧剧场/韩剧剧场频道/韩剧剧场nvod
永州综合频道	duer_0_776	永州综合频道/永州综合/永州电视台综合频道/永州电视台综合/永州综合台
永州都市频道	duer_0_777	永州都市频道/永州都市/永州电视台都市频道/永州电视台都市/永州都市台
永州公共频道	duer_0_778	永州公共频道/永州公共/永州电视台公共频道/永州电视台公共/永州公共台
永州影视频道	duer_0_779	永州影视频道/永州影视/永州电视台影视频道/永州电视台影视/永州影视台
祁阳综合频道	duer_0_780	祁阳综合频道/祁阳综合/祁阳电视台综合频道/祁阳电视台综合/祁阳综合台
祁阳生活频道	duer_0_781	祁阳生活频道/祁阳生活/祁阳电视台生活频道/祁阳电视台生活/祁阳生活台
祁阳影视频道	duer_0_782	祁阳影视频道/祁阳影视/祁阳电视台影视频道/祁阳电视台影视/祁阳影视台
3D畅享	duer_0_783	3d畅享
优化学习一	duer_0_784	优化学习一
优化学习二	duer_0_785	优化学习二
优化学习三	duer_0_786	优化学习三
彩票频道	duer_0_787	彩票频道/彩票/江苏彩票
欢乐探索	duer_0_788	欢乐探索/nvod欢乐探索
电影传奇	duer_0_789	电影传奇/nvod电影传奇
欢乐剧场	duer_0_790	欢乐剧场/nvod欢乐剧场
欢乐综艺	duer_0_791	欢乐综艺/nvod欢乐综艺
海外片场	duer_0_792	海外片场/nvod海外片场/盐城海外片场
盐城怀旧经典	duer_0_793	盐城怀旧经典/nvod怀旧经典
盐城偶像剧场	duer_0_794	盐城偶像剧场
区县频道4	duer_0_795	区县频道4
平度新闻综合	duer_0_796	平度新闻综合/平度电视台新闻综合频道/平度电视台新闻综合/平度一套/平度一/平度一台
昌平综合频道	duer_0_797	昌平综合频道/昌平综合/昌平综合台
平度旅游美食	duer_0_798	平度旅游美食/平度电视台旅游美食频道/平度电视台旅游美食/平度二套/平度二/平度二台
昌平生活频道	duer_0_799	昌平生活频道/昌平生活/昌平生活台
昌平点歌频道	duer_0_800	昌平点歌频道/昌平点歌/昌平文艺/昌平点歌台
大兴电视台	duer_0_801	大兴电视台/大兴电视
平度农科	duer_0_802	平度农科/平度电视台农科频道/平度电视台农科/平度图文
大兴资讯台	duer_0_803	大兴资讯台/大兴资讯
密云电视台1	duer_0_804	密云电视台1
密云电视台2	duer_0_805	密云电视台2
通州电视台	duer_0_806	通州电视台/通州电视
通州文艺频道	duer_0_807	通州文艺频道/通州文艺/通州电视台文艺频道/通州电视台文艺
门头沟电视台1	duer_0_808	门头沟电视台1
门头沟电视台2	duer_0_809	门头沟电视台2
怀柔电视台1	duer_0_810	怀柔电视台1
怀柔电视台2	duer_0_811	怀柔电视台2
延庆电视台	duer_0_812	延庆电视台/延庆电视
和平区台	duer_0_813	和平区台/和平区
河北区台	duer_0_814	河北区台/河北区
河东区台	duer_0_815	河东区台/河东区
河西区台	duer_0_816	河西区台/河西区
南开区台	duer_0_817	南开区台/南开区
红桥区台	duer_0_818	红桥区台/红桥区
西青新闻综合	duer_0_819	西青新闻综合/西青电视台新闻综合频道/西青电视台新闻综合/西青1/西青一套/西青一/西青一台
西青生活娱乐	duer_0_820	西青生活娱乐/西青电视台生活娱乐频道/西青电视台生活娱乐/西青2/西青二套/西青二/西青二台
宜和东部频道	duer_0_821	宜和东部频道/宜和东部/宜和东部台
南京政务	duer_0_822	南京政务
南京文教	duer_0_823	南京文教
溧水生活科教	duer_0_824	溧水生活科教/溧水电视台生活科教频道/溧水电视台生活科教
居家生活	duer_0_825	居家生活
昆山社会生活	duer_0_826	昆山社会生活
昆山电视剧	duer_0_827	昆山电视剧
昆山电影频道	duer_0_828	昆山电影频道/昆山电影
昆山城市	duer_0_829	昆山城市
余杭电视台	duer_0_830	余杭电视台/余杭电视
余杭点歌	duer_0_831	余杭点歌
余杭图文	duer_0_832	余杭图文
平安余杭	duer_0_833	平安余杭
富阳影视剧	duer_0_834	富阳影视剧/富阳电视台影视剧频道/富阳电视台影视剧
富阳图文	duer_0_835	富阳图文/富阳电视台图文频道/富阳电视台图文
桐庐综合频道	duer_0_836	桐庐综合频道/桐庐综合/桐庐电视台综合频道/桐庐电视台综合/桐庐综合台
桐庐图文频道	duer_0_837	桐庐图文频道/桐庐图文/桐庐电视台图文频道/桐庐电视台图文/桐庐图文台
桐庐影视频道	duer_0_838	桐庐影视频道/桐庐影视/桐庐电视台影视频道/桐庐电视台影视/桐庐影视台
建德综合频道	duer_0_839	建德综合频道/建德综合/建德电视台综合频道/建德电视台综合/建德综合台
建德电影频道	duer_0_840	建德电影频道/建德电影/建德电视台电影频道/建德电视台电影/建德电影台
建德娱乐频道	duer_0_841	建德娱乐频道/建德娱乐/建德娱乐台
建德戏曲频道	duer_0_842	建德戏曲频道/建德戏曲/建德戏曲台
重庆韩剧剧场	duer_0_843	重庆韩剧剧场
欧美大片频道	duer_0_844	欧美大片频道/欧美大片/欧美大片nvod
华语电影频道	duer_0_845	华语电影频道/华语电影/华语电影nvod
奉节综合	duer_0_846	奉节综合/奉节电视台新闻综合频道/奉节电视台新闻综合
奉节影视	duer_0_847	奉节影视
奉节三套	duer_0_848	奉节三套/奉节三/奉节三台
奉节四套	duer_0_849	奉节四套/奉节四/奉节四台
江津新闻综合	duer_0_850	江津新闻综合
江津经济生活	duer_0_851	江津经济生活
江津文化旅游	duer_0_852	江津文化旅游
江津图文广播	duer_0_853	江津图文广播
万州综合	duer_0_854	万州综合
三峡移民	duer_0_855	三峡移民
万州科教	duer_0_856	万州科教
万州影视	duer_0_857	万州影视
宁阳-1	duer_0_858	宁阳1/宁阳一台/宁阳一
宁阳-2	duer_0_859	宁阳2/宁阳二台/宁阳二
宁阳综艺	duer_0_860	宁阳综艺
宁阳图文	duer_0_861	宁阳图文
宁阳远教	duer_0_862	宁阳远教
沁阳经济生活	duer_0_863	沁阳经济生活
沁阳新闻综合	duer_0_864	沁阳新闻综合
沁阳影视	duer_0_865	沁阳影视
焦作影视	duer_0_866	焦作影视
焦作科教旅游	duer_0_867	焦作科教旅游/焦作电视台科教旅游频道/焦作电视台科教旅游/焦作教育频道/焦作教育/焦作教育台
睛彩焦作	duer_0_868	睛彩焦作
邵阳新闻频道	duer_0_869	邵阳新闻频道/邵阳新闻/邵阳电视台新闻综合频道/邵阳电视台新闻综合/邵阳市新闻
邵阳政法民生	duer_0_870	邵阳政法民生/邵阳电视台政法民生频道/邵阳电视台政法民生/邵阳公共频道/邵阳公共
邵阳经济旅游	duer_0_871	邵阳经济旅游/邵阳电视台经济旅游频道/邵阳电视台经济旅游/邵阳影视娱乐频道/邵阳影视娱乐
邵阳资讯频道	duer_0_872	邵阳资讯频道/邵阳资讯/邵阳电视台生活资讯频道/邵阳电视台生活资讯
黄石公共教育	duer_0_873	黄石公共教育/黄石公共教育频道/黄石公共教育台
瑞安图文	duer_0_874	瑞安图文/瑞安电视台图文频道/瑞安电视台图文
南川新闻综合	duer_0_875	南川新闻综合
南川影视娱乐	duer_0_876	南川影视娱乐
南川旅游生活	duer_0_877	南川旅游生活
合川综合频道	duer_0_878	合川综合频道/合川综合/合川综合台
合川影视频道	duer_0_879	合川影视频道/合川影视/合川影视台
合川都市频道	duer_0_880	合川都市频道/合川都市/合川都市台
合川公共资讯频道	duer_0_881	合川公共资讯频道/合川公共资讯/合川公共资讯台
永川综合频道	duer_0_882	永川综合频道/永川综合/永川电视台综合频道/永川电视台综合/永川综合台
永川都市频道	duer_0_883	永川都市频道/永川都市/永川电视台都市频道/永川电视台都市/永川都市台
永川生活频道	duer_0_884	永川生活频道/永川生活/永川电视台生活频道/永川电视台生活/永川生活台
涪陵综合频道	duer_0_885	涪陵综合频道/涪陵综合/涪陵电视台新闻综合频道/涪陵电视台新闻综合/涪陵一套/涪陵一/涪陵一台
涪陵都市频道	duer_0_886	涪陵都市频道/涪陵都市/涪陵电视台都市频道/涪陵电视台都市/涪陵二台/涪陵二
涪陵科教频道	duer_0_887	涪陵科教频道/涪陵科教/涪陵电视台科教频道/涪陵电视台科教/涪陵三套/涪陵三/涪陵三台
涪陵四套	duer_0_888	涪陵四套/涪陵四
NV 新闻	duer_0_889	nv 新闻/nv 新闻 441始点播/nvod新闻财经/441始点播
NV 娱乐	duer_0_890	nv 娱乐/nv 娱乐 444始点播/nvod娱乐集锦/444始点播
NV 专题	duer_0_891	nv 专题/nv 专题 447始点播/nvod专题实录/447始点播
NV 戏曲	duer_0_892	nv 戏曲/nv 戏曲 450始点播/nvod戏曲天地/450始点播
宝丰一套	duer_0_893	宝丰一套/宝丰一/宝丰一台
宝丰二套	duer_0_894	宝丰二套/宝丰二/宝丰二台
宝丰点播	duer_0_895	宝丰点播
宝丰文化	duer_0_896	宝丰文化/宝丰文化台
云视精品	duer_0_897	云视精品
IPTV纪录	duer_0_898	iptv纪录
宁河-1	duer_0_899	宁河1/宁河一台/宁河一
宁河-2	duer_0_900	宁河2/宁河二台/宁河二
宁河-3	duer_0_901	宁河3/宁河三台/宁河三
蔡甸综合频道	duer_0_902	蔡甸综合频道/蔡甸综合
蔡甸影视频道	duer_0_903	蔡甸影视频道/蔡甸影视
蔡甸资讯频道1	duer_0_904	蔡甸资讯频道1
蔡甸资讯频道2	duer_0_905	蔡甸资讯频道2
天气资讯	duer_0_906	天气资讯
沙发影院	duer_0_907	沙发影院/沙发影院首页/沙发院线导视/沙发院线
沙发院线三厅	duer_0_908	沙发院线三厅
费县综合频道	duer_0_909	费县综合频道/费县综合
费县生活频道	duer_0_910	费县生活频道/费县生活
费县影视频道	duer_0_911	费县影视频道/费县影视
费县导视频道	duer_0_912	费县导视频道/费县导视
十堰精彩	duer_0_913	十堰精彩
萍乡影视频道	duer_0_914	萍乡影视频道/萍乡影视/萍乡电视台影视频道/萍乡电视台影视/pxtv4/萍乡影视台
绵阳服务信息	duer_0_915	绵阳服务信息
绵阳新农村	duer_0_916	绵阳新农村
调兵山1台	duer_0_917	调兵山1台/调兵山1
调兵山2台	duer_0_918	调兵山2台/调兵山2
调兵山3台	duer_0_919	调兵山3台/调兵山3
开原1台	duer_0_920	开原1台/开原1
开原2台	duer_0_921	开原2台/开原2
开原3台	duer_0_922	开原3台/开原3
XFTV-1	duer_0_923	xftv1/西丰一台/西丰一
XFTV-2	duer_0_924	xftv2/西丰二台/西丰二
西丰图文	duer_0_925	西丰图文/西丰图文台
章丘新闻综合	duer_0_926	章丘新闻综合
章丘农科	duer_0_927	章丘农科/章丘农科频道
章丘生活综艺	duer_0_928	章丘生活综艺
章丘党建	duer_0_929	章丘党建
胶州新闻综合	duer_0_930	胶州新闻综合
胶州经济生活	duer_0_931	胶州经济生活
胶州影视综艺	duer_0_932	胶州影视综艺
胶州电影频道	duer_0_933	胶州电影频道/胶州电影
招远综合频道	duer_0_934	招远综合频道/招远综合/招远电视台综合频道/招远电视台综合/招远综合台
招远综艺频道	duer_0_935	招远综艺频道/招远综艺/招远电视台综艺频道/招远电视台综艺/招远综艺台
招远图文信息	duer_0_936	招远图文信息/招远电视台图文信息
JRTV	duer_0_937	jrtv
烟台商务频道	duer_0_938	烟台商务频道/烟台商务/频道无台标/烟台商务台
烟台时尚频道	duer_0_939	烟台时尚频道/烟台时尚/烟台时尚台
贵阳新闻荟萃	duer_0_940	贵阳新闻荟萃
麻城综合频道	duer_0_941	麻城综合频道/麻城综合/麻城综合台
麻城影视频道	duer_0_942	麻城影视频道/麻城影视/麻城影视台
麻城科教频道	duer_0_943	麻城科教频道/麻城科教/麻城科教台
麻城资讯频道	duer_0_944	麻城资讯频道/麻城资讯/麻城资讯台
麻城垄上频道	duer_0_945	麻城垄上频道/麻城垄上/麻城垄上台
惠民一台	duer_0_946	惠民一台/惠民一
惠民二台	duer_0_947	惠民二台/惠民二
惠民三台	duer_0_948	惠民三台/惠民三
滨州电视指南	duer_0_949	滨州电视指南
武安综合频道	duer_0_950	武安综合频道/武安综合/武安综合台
武安转播频道	duer_0_951	武安转播频道/武安转播/武安转播台
武安科技频道	duer_0_952	武安科技频道/武安科技/武安科技台
武安政务频道	duer_0_953	武安政务频道/武安政务/武安政务公开频道/武安政务公开/武安政务台
武安电影频道	duer_0_954	武安电影频道/武安电影/武安电影台
兴隆综合频道	duer_0_955	兴隆综合频道/兴隆综合/兴隆电视台综合频道/兴隆电视台综合/兴隆综合台
兴隆影视频道	duer_0_956	兴隆影视频道/兴隆影视/兴隆电视台影视频道/兴隆电视台影视/兴隆影视台
兴隆旅游频道	duer_0_957	兴隆旅游频道/兴隆旅游/兴隆电视台旅游频道/兴隆电视台旅游/兴隆旅游台
乐宅电影频道	duer_0_958	乐宅电影频道/乐宅电影/乐宅电影台
承德广通导视	duer_0_959	承德广通导视
承德广通电影	duer_0_960	承德广通电影
连播剧场频道	duer_0_961	连播剧场频道/连播剧场/连播剧场台
赛场直击频道	duer_0_962	赛场直击频道/赛场直击/赛场直击台
娱乐星空频道	duer_0_963	娱乐星空频道/娱乐星空/娱乐星空台
名家论道频道	duer_0_964	名家论道频道/名家论道/名家论道台
鄞州电视台	duer_0_965	鄞州电视台/鄞州电视
鄞州生活资讯	duer_0_966	鄞州生活资讯/鄞州电视台生活资讯频道/鄞州电视台生活资讯
鄞州潮流资讯	duer_0_967	鄞州潮流资讯/鄞州电视台潮流资讯频道/鄞州电视台潮流资讯
丰县生活频道	duer_0_968	丰县生活频道/丰县生活/丰县电视台生活频道/丰县电视台生活/丰县生活台
丰县新闻频道	duer_0_969	丰县新闻频道/丰县新闻/丰县新闻台
丰县新农村频道	duer_0_970	丰县新农村频道/丰县新农村/丰县新农村台
爱看导视	duer_0_971	爱看导视
沛县经济频道	duer_0_972	沛县经济频道/沛县经济/沛县电视台经济生活频道/沛县电视台经济生活/沛县经济生活频道/沛县经济生活/沛县经济生活台
沛县新闻频道	duer_0_973	沛县新闻频道/沛县新闻/沛县电视台新闻综合频道/沛县电视台新闻综合/沛县新闻综合频道/沛县新闻综合/沛县新闻综合台
沛县文艺频道	duer_0_974	沛县文艺频道/沛县文艺/沛县电视台文艺影视频道/沛县电视台文艺影视/沛县文艺影视频道/沛县文艺影视/沛县文艺影视台
数字电视导视	duer_0_975	数字电视导视/数字电视节目导视
数字电视指南	duer_0_976	数字电视指南/数字电视使用指南
林州综合频道	duer_0_977	林州综合频道/林州综合/林州电视台新闻综合频道/林州电视台新闻综合/林州新闻综合/林州新闻综合台
林州生活频道	duer_0_978	林州生活频道/林州生活/林州电视台生活经济频道/林州电视台生活经济/林州生活经济台/林州生活经济
林州文化旅游	duer_0_979	林州文化旅游/林州电视台文化旅游频道/林州电视台文化旅游/林州文化旅游台
红旗渠党建	duer_0_980	红旗渠党建/林州红旗渠党建频道/林州红旗渠党建/红旗渠党建台
醴陵综合频道	duer_0_981	醴陵综合频道/醴陵综合/醴陵电视台综合频道/醴陵电视台综合/醴陵综合台
醴陵经视	duer_0_982	醴陵经视/醴陵经视台
醴陵影视频道	duer_0_983	醴陵影视频道/醴陵影视/醴陵电视台影视频道/醴陵电视台影视/醴陵影视台
醴陵资讯频道	duer_0_984	醴陵资讯频道/醴陵资讯/醴陵电视台资讯频道/醴陵电视台资讯/醴陵资讯台
醴陵图文频道	duer_0_985	醴陵图文频道/醴陵图文/醴陵电视台图文频道/醴陵电视台图文/醴陵图文台
天天健康频道	duer_0_986	天天健康频道/天天健康/湖南天天健康频道/湖南天天健康
黔东南一频道	duer_0_987	黔东南一频道/黔东南一/黔东南新闻综合频道/黔东南新闻综合/黔东南一台
黔东南二频道	duer_0_988	黔东南二频道/黔东南二/黔东南公共频道/黔东南公共/黔东南二台
黔东南三频道	duer_0_989	黔东南三频道/黔东南三/黔东南三台
黔东南四频道	duer_0_990	黔东南四频道/黔东南四/黔东南四台
黔东南五频道	duer_0_991	黔东南五频道/黔东南五/黔东南五台
汉南综合频道	duer_0_992	汉南综合频道/汉南综合/汉南综合台
汉南资讯频道	duer_0_993	汉南资讯频道/汉南资讯/汉南资讯台
汉南影视频道	duer_0_994	汉南影视频道/汉南影视/汉南影视台
夏津综合频道	duer_0_995	夏津综合频道/夏津综合/夏津综合台
夏津公共频道	duer_0_996	夏津公共频道/夏津公共/夏津公共台
夏津民生频道	duer_0_997	夏津民生频道/夏津民生/夏津民生台
夏津综艺频道	duer_0_998	夏津综艺频道/夏津综艺/夏津综艺台
夏津党建频道	duer_0_999	夏津党建频道/夏津党建/夏津党建台
沙发院线一厅	duer_0_1000	沙发院线一厅/云媒体视界
沙发院线二厅	duer_0_1001	沙发院线二厅/我的南京·tv版/沙发影院二厅
城市大明星频道	duer_0_1002	城市大明星频道/城市大明星
蓉城先锋频道	duer_0_1003	蓉城先锋频道/蓉城先锋
食尚频道	duer_0_1004	食尚频道/食尚
汽车频道	duer_0_1005	汽车频道/汽车
美食旅游频道	duer_0_1006	美食旅游频道/美食旅游
首播剧场频道	duer_0_1007	首播剧场频道/首播剧场
巴中新闻综合	duer_0_1008	巴中新闻综合/巴中电视台新闻综合频道/巴中电视台新闻综合/巴中一套/巴中一/巴中综合频道/巴中综合
巴中经济生活	duer_0_1009	巴中经济生活/巴中经济生活频道/巴中二套/巴中二
巴中影视娱乐	duer_0_1010	巴中影视娱乐/巴中影视娱乐频道/巴中三套/巴中三
巴中时政资讯	duer_0_1011	巴中时政资讯/巴中时政资讯频道/巴中时政台/巴中时政
诸城新闻频道	duer_0_1012	诸城新闻频道/诸城新闻/诸城电视台新闻频道/诸城电视台新闻/诸城新闻台
诸城生活频道	duer_0_1013	诸城生活频道/诸城生活/诸城电视台生活频道/诸城电视台生活/诸城生活台
诸城影视频道	duer_0_1014	诸城影视频道/诸城影视/诸城电视台影视频道/诸城电视台影视/诸城影视台
诸城娱乐频道	duer_0_1015	诸城娱乐频道/诸城娱乐/诸城电视台娱乐频道/诸城电视台娱乐/诸城娱乐台
诸城党建频道	duer_0_1016	诸城党建频道/诸城党建/诸城电视台党建频道/诸城电视台党建/诸城党建台
泸州科教频道	duer_0_1017	泸州科教频道/泸州科教/泸州电视台科教频道/泸州电视台科教/泸州科教台
吕梁影视生活	duer_0_1018	吕梁影视生活/吕梁电视台影视生活频道/吕梁电视台影视生活/吕梁2/吕梁二台/吕梁二
淮南科教频道	duer_0_1019	淮南科教频道/淮南科教/淮南电视台科教频道/淮南电视台科教/淮南四套/淮南四/淮南四台
海阳新闻综合	duer_0_1020	海阳新闻综合/海阳新闻综合频道/海阳新闻台/海阳新闻
海阳综艺频道	duer_0_1021	海阳综艺频道/海阳综艺/海阳综艺台
海阳影视频道	duer_0_1022	海阳影视频道/海阳影视/海阳影视台
海阳图文资讯	duer_0_1023	海阳图文资讯/海阳图文资讯频道/海阳图文台/海阳图文/海阳图文频道
海阳党建频道	duer_0_1024	海阳党建频道/海阳党建/海阳党建台
商河综合频道	duer_0_1025	商河综合频道/商河综合/商河电视台新闻综合频道/商河电视台新闻综合
商河正能量频道	duer_0_1026	商河正能量频道/商河正能量/商河电视台正能量频道/商河电视台正能量
商河影视频道	duer_0_1027	商河影视频道/商河影视/商河电视台影视频道/商河电视台影视
莒南综合频道	duer_0_1028	莒南综合频道/莒南综合/莒南综合台
莒南影视频道	duer_0_1029	莒南影视频道/莒南影视/莒南影视台
莒南导视频道	duer_0_1030	莒南导视频道/莒南导视/莒南导视台
莒南资讯频道	duer_0_1031	莒南资讯频道/莒南资讯/莒南资讯台
忻州综合频道	duer_0_1032	忻州综合频道/忻州综合/忻州综合台
忻州公共频道	duer_0_1033	忻州公共频道/忻州公共/忻州公共台
忻州影视频道	duer_0_1034	忻州影视频道/忻州影视/忻州影视台
睛彩忻州	duer_0_1035	睛彩忻州
怀化影视娱乐频道	duer_0_1036	怀化影视娱乐频道/怀化影视娱乐/怀化影视娱乐台
怀化文化旅游频道	duer_0_1037	怀化文化旅游频道/怀化文化旅游/怀化文化旅游台
江门生活频道	duer_0_1038	江门生活频道/江门生活
青岛导视频道	duer_0_1039	青岛导视频道/青岛导视
QTV-移动	duer_0_1040	qtv移动
多彩互动	duer_0_1041	多彩互动
藁城新闻综合	duer_0_1042	藁城新闻综合/藁城新闻台/藁城新闻
藁城生活资讯	duer_0_1043	藁城生活资讯/藁城生活台/藁城生活
茌平一台	duer_0_1044	茌平一台/茌平一
茌平二台	duer_0_1045	茌平二台/茌平二
茌平三台	duer_0_1046	茌平三台/茌平三
茌平四台	duer_0_1047	茌平四台/茌平四
寿光新闻频道	duer_0_1048	寿光新闻频道/寿光新闻/寿光新闻台
寿光蔬菜频道	duer_0_1049	寿光蔬菜频道/寿光蔬菜/寿光蔬菜台
寿光生活频道	duer_0_1050	寿光生活频道/寿光生活/寿光生活台
寿光国学频道	duer_0_1051	寿光国学频道/寿光国学/寿光国学台
寿光党建频道	duer_0_1052	寿光党建频道/寿光党建/寿光党建台
姚江文化频道	duer_0_1053	姚江文化频道/姚江文化/余姚电视台姚江文化频道/余姚电视台姚江文化
余姚新闻综合	duer_0_1054	余姚新闻综合/余姚电视台新闻综合频道/余姚电视台新闻综合
幸福生活频道	duer_0_1055	幸福生活频道/幸福生活/余姚电视台幸福生活频道/余姚电视台幸福生活
黔南新闻频道	duer_0_1056	黔南新闻频道/黔南新闻/黔南新闻台
黔南都市频道	duer_0_1057	黔南都市频道/黔南都市/黔南都市台
黔南公共频道	duer_0_1058	黔南公共频道/黔南公共/黔南公共台
黔南娱乐频道	duer_0_1059	黔南娱乐频道/黔南娱乐/黔南娱乐台
黔南图文台	duer_0_1060	黔南图文台/黔南图文
桦南一套	duer_0_1061	桦南一套/桦南一/桦南一台
桦南二套	duer_0_1062	桦南二套/桦南二/桦南二台
桦南三套	duer_0_1063	桦南三套/桦南三/桦南三台
乐清新闻综合	duer_0_1064	乐清新闻综合/乐清新闻台/乐清新闻
乐清经济生活	duer_0_1065	乐清经济生活/乐清经济台/乐清经济
乐清影视频道	duer_0_1066	乐清影视频道/乐清影视/乐清影视台
乐清图文电视	duer_0_1067	乐清图文电视/乐清图文台/乐清图文
蕲春综合频道	duer_0_1068	蕲春综合频道/蕲春综合/蕲春电视台综合频道/蕲春电视台综合/蕲春台/蕲春
蕲春旅游养生	duer_0_1069	蕲春旅游养生/蕲春电视台旅游养生频道/蕲春电视台旅游养生
蕲春文娱频道	duer_0_1070	蕲春文娱频道/蕲春文娱/蕲春电视台文娱频道/蕲春电视台文娱
蕲春资讯频道	duer_0_1071	蕲春资讯频道/蕲春资讯/蕲春电视台资讯频道/蕲春电视台资讯
蕲春影视频道	duer_0_1072	蕲春影视频道/蕲春影视/蕲春电视台影视频道/蕲春电视台影视
蕲春经济频道	duer_0_1073	蕲春经济频道/蕲春经济/蕲春经济台
正定新闻频道	duer_0_1074	正定新闻频道/正定新闻/正定县新闻频道/正定县新闻/正定新闻台
正定民生频道	duer_0_1075	正定民生频道/正定民生/正定县民生频道/正定县民生/正定民生台
正定快乐3频道	duer_0_1076	正定快乐3频道/正定快乐3/正定快乐3台
正定图文信息	duer_0_1077	正定图文信息/正定图文台/正定图文/正定信息台/正定信息/正定图文信息台
正定电视剧频道	duer_0_1078	正定电视剧频道/正定电视剧/正定电视剧台
长葛新闻综合	duer_0_1079	长葛新闻综合/长葛新闻台/长葛新闻
长葛经济生活	duer_0_1080	长葛经济生活/长葛经济生活台/长葛经济台/长葛经济
长葛葛天文化	duer_0_1081	长葛葛天文化/长葛葛天文化台
长葛图文频道	duer_0_1082	长葛图文频道/长葛图文/长葛图文台
黑龙江骄阳剧场	duer_0_1083	黑龙江骄阳剧场/湖北骄阳剧场台/湖北骄阳剧场/骄阳大剧台/骄阳大剧
川网宜宾导视	duer_0_1084	川网宜宾导视/川网宜宾导视频道
象山台	duer_0_1085	象山台/象山
象山影视娱乐	duer_0_1086	象山影视娱乐
象山图文信息	duer_0_1087	象山图文信息
阜新综合频道	duer_0_1088	阜新综合频道/阜新综合/阜新综合台
阜新公共频道	duer_0_1089	阜新公共频道/阜新公共/阜新公共台
阜新教育频道	duer_0_1090	阜新教育频道/阜新教育/阜新教育台
阜新图文频道	duer_0_1091	阜新图文频道/阜新图文/阜新有线图文频道/阜新有线图文/阜新图文台
宁乡综合频道	duer_0_1092	宁乡综合频道/宁乡综合
宁乡戏曲频道	duer_0_1093	宁乡戏曲频道/宁乡戏曲
宁乡生活频道	duer_0_1094	宁乡生活频道/宁乡生活
宁乡电视剧频道	duer_0_1095	宁乡电视剧频道/宁乡电视剧
宁乡房产频道	duer_0_1096	宁乡房产频道/宁乡房产
宁乡图文房产	duer_0_1097	宁乡图文房产
宁乡图文信息	duer_0_1098	宁乡图文信息
桦甸新闻综合频道	duer_0_1099	桦甸新闻综合频道/桦甸新闻综合/桦甸新闻综合台
桦甸影视频道	duer_0_1100	桦甸影视频道/桦甸影视/桦甸影视台
桦甸生活频道	duer_0_1101	桦甸生活频道/桦甸生活/桦甸生活台
桦甸娱乐频道	duer_0_1102	桦甸娱乐频道/桦甸娱乐/桦甸娱乐台
迁安一台	duer_0_1103	迁安一台/迁安一
迁安二台	duer_0_1104	迁安二台/迁安二
迁安快乐3频道	duer_0_1105	迁安快乐3频道/迁安快乐3/迁安快乐3台
迁安影视频道	duer_0_1106	迁安影视频道/迁安影视/迁安影视台
奉化综合频道	duer_0_1107	奉化综合频道/奉化综合/奉化电视台新闻综合频道/奉化电视台新闻综合/奉化一套/奉化一/奉化一台/奉化综合台
奉化生活频道	duer_0_1108	奉化生活频道/奉化生活/奉化电视台生活娱乐频道/奉化电视台生活娱乐/奉化二套/奉化二/奉化二台/奉化生活台
奉化图文信息	duer_0_1109	奉化图文信息/奉化电视台图文信息频道/奉化电视台图文信息/奉化图文台/奉化图文
网络服务	duer_0_1110	网络服务
睛彩台州	duer_0_1111	睛彩台州/睛彩台州频道
望城新闻频道	duer_0_1112	望城新闻频道/望城新闻/望城电视台新闻频道/望城电视台新闻
望城文艺频道	duer_0_1113	望城文艺频道/望城文艺/望城电视台文艺频道/望城电视台文艺
望城生活频道	duer_0_1114	望城生活频道/望城生活/望城电视台生活频道/望城电视台生活
望城信息频道	duer_0_1115	望城信息频道/望城信息/望城电视台信息频道/望城电视台信息
测试频道20	duer_0_1116	测试频道20
众创TV频道	duer_0_1117	众创tv频道/众创tv/众创tv台
嘉峪关综合频道	duer_0_1118	嘉峪关综合频道/嘉峪关综合/嘉峪关综合台
嘉峪关公共频道	duer_0_1119	嘉峪关公共频道/嘉峪关公共/嘉峪关公共台
嘉峪关图文频道	duer_0_1120	嘉峪关图文频道/嘉峪关图文/嘉峪关图文台
海安新闻综合	duer_0_1121	海安新闻综合/海安电视台新闻综合频道/海安电视台新闻综合/海安新闻台/海安新闻/海安综合台/海安综合
海安影视频道	duer_0_1122	海安影视频道/海安影视/海安电视台影视频道/海安电视台影视/海安影视台
海安生活频道	duer_0_1123	海安生活频道/海安生活/海安电视台生活频道/海安电视台生活/海安生活台
海安娱乐频道	duer_0_1124	海安娱乐频道/海安娱乐/海安电视台娱乐频道/海安电视台娱乐/海安娱乐台
烟台导视频道	duer_0_1125	烟台导视频道/烟台导视/烟台导视台
宜兴生活频道	duer_0_1126	宜兴生活频道/宜兴生活/宜兴电视台生活频道/宜兴电视台生活/宜兴生活台
宜兴影视频道	duer_0_1127	宜兴影视频道/宜兴影视/宜兴电视台影视频道/宜兴电视台影视/宜兴影视台
宜兴紫砂频道	duer_0_1128	宜兴紫砂频道/宜兴紫砂/宜兴电视台紫砂频道/宜兴电视台紫砂/宜兴紫砂台
安康一套	duer_0_1129	安康一套/安康一/安康一台
安康二套	duer_0_1130	安康二套/安康二/安康二台
睛彩安康	duer_0_1131	睛彩安康
安康四套	duer_0_1132	安康四套/安康四/安康四台
安康教育	duer_0_1133	安康教育/安康教育台
本溪法治频道	duer_0_1134	本溪法治频道/本溪法治/本溪电视台法制频道/本溪电视台法制/本溪法治台
辽源教育频道	duer_0_1135	辽源教育频道/辽源教育/辽源电视台教育频道/辽源电视台教育/辽源教育台
临沂导视频道	duer_0_1136	临沂导视频道/临沂导视/临沂电视台导视频道/临沂电视台导视
苍南一套	duer_0_1137	苍南一套/苍南一/苍南一台
苍南二套	duer_0_1138	苍南二套/苍南二/苍南二台
苍南图文	duer_0_1139	苍南图文/苍南图文台
苍南音乐	duer_0_1140	苍南音乐/苍南音乐台
睛彩湖北	duer_0_1141	睛彩湖北
益阳电视台赫山频道	duer_0_1142	益阳电视台赫山频道/益阳电视台赫山/益阳赫山台/益阳赫山
嘉善新闻综合	duer_0_1143	嘉善新闻综合/嘉善电视台新闻综合频道/嘉善电视台新闻综合
嘉善善文化	duer_0_1144	嘉善善文化/嘉善电视台善文化频道/嘉善电视台善文化
嘉善影视娱乐	duer_0_1145	嘉善影视娱乐/嘉善电视台影视娱乐频道/嘉善电视台影视娱乐
嘉善图文信息	duer_0_1146	嘉善图文信息/嘉善电视台图文信息频道/嘉善电视台图文信息
抚州三套	duer_0_1147	抚州三套/抚州三/抚州三台
玉林互动信息	duer_0_1148	玉林互动信息/玉林电视台互动信息频道/玉林电视台互动信息
玉林互动娱乐	duer_0_1149	玉林互动娱乐/玉林电视台互动娱乐频道/玉林电视台互动娱乐
玉林互动音乐	duer_0_1150	玉林互动音乐/玉林电视台互动音乐频道/玉林电视台互动音乐
鄂州新闻频道	duer_0_1151	鄂州新闻频道/鄂州新闻/鄂州电视台新闻频道/鄂州电视台新闻/鄂州新闻台
鄂州经视频道	duer_0_1152	鄂州经视频道/鄂州经视/鄂州电视台经视频道/鄂州电视台经视/鄂州经视台
鄂州综艺频道	duer_0_1153	鄂州综艺频道/鄂州综艺/鄂州电视台综艺频道/鄂州电视台综艺/鄂州综艺台
鄂州图文信息	duer_0_1154	鄂州图文信息/鄂州图文台/鄂州图文
东营图文频道	duer_0_1155	东营图文频道/东营图文/东营电视台图文频道/东营电视台图文
建德生活文体频道	duer_0_1156	建德生活文体频道/建德生活文体/建德电视台生活文体频道/建德电视台生活文体/建德生活文体台
灯塔综合频道	duer_0_1157	灯塔综合频道/灯塔综合/灯塔电视台综合频道/灯塔电视台综合
灯塔图文频道	duer_0_1158	灯塔图文频道/灯塔图文/灯塔电视台图文频道/灯塔电视台图文/灯塔图文台
灯塔娱乐频道	duer_0_1159	灯塔娱乐频道/灯塔娱乐/灯塔电视台娱乐频道/灯塔电视台娱乐/灯塔娱乐台
晋江民生频道	duer_0_1160	晋江民生频道/晋江民生/晋江电视台民生频道/晋江电视台民生
睛彩河北频道	duer_0_1161	睛彩河北频道/睛彩河北
平凉综合频道	duer_0_1162	平凉综合频道/平凉综合/平凉综合台
平凉公共频道	duer_0_1163	平凉公共频道/平凉公共/平凉公共台
永嘉公共频道	duer_0_1164	永嘉公共频道/永嘉公共/永嘉公共台
永嘉招工频道	duer_0_1165	永嘉招工频道/永嘉招工/永嘉招工台
铜陵综合频道	duer_0_1166	铜陵综合频道/铜陵综合/铜陵电视台新闻综合频道/铜陵电视台新闻综合/铜陵一套/铜陵一/铜陵一台
铜陵生活频道	duer_0_1167	铜陵生活频道/铜陵生活/铜陵电视台生活服务频道/铜陵电视台生活服务/铜陵二套/铜陵二/铜陵二台
铜陵影视娱乐频道	duer_0_1168	铜陵影视娱乐频道/铜陵影视娱乐/铜陵电视台影视娱乐频道/铜陵电视台影视娱乐/铜陵三套/铜陵三/铜陵三台
上虞新闻综合	duer_0_1169	上虞新闻综合/上虞新闻台/上虞新闻/上虞新闻综合台
上虞经济文化	duer_0_1170	上虞经济文化/上虞经济台/上虞经济
上虞新商都	duer_0_1171	上虞新商都/上虞新商都频道
上虞图文频道	duer_0_1172	上虞图文频道/上虞图文/上虞图文信息频道/上虞图文信息/上虞图文台
测试频道21	duer_0_1173	测试频道21
测试频道22	duer_0_1174	测试频道22
测试频道23	duer_0_1175	测试频道23
测试频道24	duer_0_1176	测试频道24
测试频道25	duer_0_1177	测试频道25
测试频道26	duer_0_1178	测试频道26
测试频道27	duer_0_1179	测试频道27
启东新闻综合	duer_0_1180	启东新闻综合/启东新闻综合台/启东新闻台/启东新闻/启东综合台/启东综合
启东社会生活	duer_0_1181	启东社会生活/启东社会生活台/启东电视台社会生活台/启东电视台社会生活
启东电视剧	duer_0_1182	启东电视剧/启东电视剧台
启东影视	duer_0_1183	启东影视/启东影视台/启东电视台影视台/启东电视台影视
启东公共	duer_0_1184	启东公共/启东公共台/启东电视台公共台/启东电视台公共
鹰潭电视剧频道	duer_0_1185	鹰潭电视剧频道/鹰潭电视剧/鹰潭电视台电视剧频道/鹰潭电视台电视剧
鹰潭电影频道	duer_0_1186	鹰潭电影频道/鹰潭电影/鹰潭电视台电影频道/鹰潭电视台电影
贵溪综合频道	duer_0_1187	贵溪综合频道/贵溪综合/贵溪电视台综合频道/贵溪电视台综合/贵溪综合台
贵溪影视频道	duer_0_1188	贵溪影视频道/贵溪影视/贵溪电视台影视频道/贵溪电视台影视/贵溪影视台
贵溪都市频道	duer_0_1189	贵溪都市频道/贵溪都市/贵溪电视台都市频道/贵溪电视台都市/贵溪都市台
贵溪生活频道	duer_0_1190	贵溪生活频道/贵溪生活/贵溪电视台生活频道/贵溪电视台生活/贵溪生活台
尚志新闻综合	duer_0_1191	尚志新闻综合
尚志公共	duer_0_1192	尚志公共
尚志生活	duer_0_1193	尚志生活
尚志娱乐	duer_0_1194	尚志娱乐
尚志影视	duer_0_1195	尚志影视
乌兰察布生活	duer_0_1196	乌兰察布生活/乌兰察布电视台生活频道/乌兰察布电视台生活/乌兰察布3/乌兰察布三台/乌兰察布三
阜阳综合频道	duer_0_1197	阜阳综合频道/阜阳综合/阜阳电视台新闻综合频道/阜阳电视台新闻综合/阜阳新闻频道/阜阳新闻
阜阳公共频道	duer_0_1198	阜阳公共频道/阜阳公共/阜阳电视台公共频道/阜阳电视台公共
阜阳都市频道	duer_0_1199	阜阳都市频道/阜阳都市/阜阳电视台都市频道/阜阳电视台都市
阜阳科教农	duer_0_1200	阜阳科教农/阜阳电视台科教农频道/阜阳电视台科教农/阜阳教育
新郑综合频道	duer_0_1201	新郑综合频道/新郑综合/新郑综合台
新郑农村频道	duer_0_1202	新郑农村频道/新郑农村/新郑农村台
新郑城市频道	duer_0_1203	新郑城市频道/新郑城市/新郑城市台
新郑道德频道	duer_0_1204	新郑道德频道/新郑道德/新郑道德台
新郑图文信息	duer_0_1205	新郑图文信息/新郑图文台/新郑图文
东莞剧院	duer_0_1206	东莞剧院
海林新闻频道	duer_0_1207	海林新闻频道/海林新闻/海林电视台新闻频道/海林电视台新闻/海林新闻台
海林影视频道	duer_0_1208	海林影视频道/海林影视/海林电视台影视频道/海林电视台影视/海林影视台
海林文艺频道	duer_0_1209	海林文艺频道/海林文艺/海林电视台文艺频道/海林电视台文艺/海林文艺台
鹤岗文艺频道	duer_0_1210	鹤岗文艺频道/鹤岗文艺/鹤岗文艺台
鹤岗影视频道	duer_0_1211	鹤岗影视频道/鹤岗影视/鹤岗影视台
漯河新闻综合	duer_0_1212	漯河新闻综合/漯河电视台新闻综合频道/漯河电视台新闻综合/漯河新闻频道/漯河新闻
SCCN农教资讯	duer_0_1213	sccn农教资讯/sccn农教资讯频道/四川农教资讯
莱州综合频道	duer_0_1214	莱州综合频道/莱州综合/莱州综合台
莱州影视频道	duer_0_1215	莱州影视频道/莱州影视/莱州影视台
莱州商务频道	duer_0_1216	莱州商务频道/莱州商务/莱州商务台
绥化新闻频道	duer_0_1217	绥化新闻频道/绥化新闻/绥化电视台新闻综合频道/绥化电视台新闻综合/绥化综合台/绥化综合
绥化公共频道	duer_0_1218	绥化公共频道/绥化公共/绥化电视台公共频道/绥化电视台公共/绥化公共台
沭阳科教频道	duer_0_1219	沭阳科教频道/沭阳科教/沭阳电视台科教频道/沭阳电视台科教/沭阳科教台
沭阳综艺频道	duer_0_1220	沭阳综艺频道/沭阳综艺/沭阳电视台综艺频道/沭阳电视台综艺/沭阳综艺台
沭阳影视频道	duer_0_1221	沭阳影视频道/沭阳影视/沭阳电视台影视频道/沭阳电视台影视/沭阳影视台
沭阳图文频道	duer_0_1222	沭阳图文频道/沭阳图文/沭阳电视台图文频道/沭阳电视台图文/沭阳图文台
爱看剧场	duer_0_1223	爱看剧场/爱看剧场频道
欧美精选	duer_0_1224	欧美精选/欧美精选频道/湖北欧美剧场频道/湖北欧美剧场
星合影视	duer_0_1225	星合影视/星合影视频道
奇观天下	duer_0_1226	奇观天下/奇观天下频道
澧县综合频道	duer_0_1227	澧县综合频道/澧县综合/澧县电视台综合频道/澧县电视台综合/澧县综合台
澧县综艺频道	duer_0_1228	澧县综艺频道/澧县综艺/澧县电视台综艺频道/澧县电视台综艺/澧县综艺台
澧县影视剧频道	duer_0_1229	澧县影视剧频道/澧县影视剧/澧县电视台影视剧频道/澧县电视台影视剧/澧县影视剧台
澧县文化生活频道	duer_0_1230	澧县文化生活频道/澧县文化生活/澧县电视台文化生活频道/澧县电视台文化生活/澧县文化台/澧县文化/澧县生活台/澧县生活
衡阳都市频道	duer_0_1231	衡阳都市频道/衡阳都市/衡阳电视台都市频道/衡阳电视台都市/衡阳都市台
衡阳生活频道	duer_0_1232	衡阳生活频道/衡阳生活/衡阳电视台生活频道/衡阳电视台生活/衡阳生活台
衡阳娱乐频道	duer_0_1233	衡阳娱乐频道/衡阳娱乐/衡阳电视台娱乐频道/衡阳电视台娱乐/衡阳娱乐台
衡阳资讯频道	duer_0_1234	衡阳资讯频道/衡阳资讯/衡阳电视台资讯频道/衡阳电视台资讯/衡阳资讯台
衡阳党建先锋频道	duer_0_1235	衡阳党建先锋频道/衡阳党建先锋/衡阳党建先锋台
多彩云导视	duer_0_1236	多彩云导视
睛彩渭南	duer_0_1237	睛彩渭南
骄阳剧场频道	duer_0_1238	骄阳剧场频道/骄阳剧场/湖北骄阳剧场频道/湖北骄阳剧场/骄阳大剧频道/骄阳大剧
宣城新闻综合	duer_0_1239	宣城新闻综合/宣城电视台新闻综合频道/宣城电视台新闻综合/宣城新闻频道/宣城新闻
宣城经济生活	duer_0_1240	宣城经济生活/宣城电视台经济生活频道/宣城电视台经济生活/宣城公共
宣城影视频道	duer_0_1241	宣城影视频道/宣城影视/宣城电视台影视文化频道/宣城电视台影视文化/宣城三套/宣城三
睛彩云南	duer_0_1242	睛彩云南
乐山生活·纪录	duer_0_1243	乐山生活·纪录/乐山电视台生活·纪录频道/乐山电视台生活·纪录
SCN互动证券	duer_0_1244	scn互动证券
河北新闻录播	duer_0_1245	河北新闻录播/河北电视台新闻录播
嘉丽购物频道	duer_0_1246	嘉丽购物频道/嘉丽购物/嘉丽购
CNTV城市剧场	duer_0_1247	cntv城市剧场
CNTV音乐现场	duer_0_1248	cntv音乐现场
CNTV军旅剧场	duer_0_1249	cntv军旅剧场
CNTV足球	duer_0_1250	cntv足球
CNTV古装剧场	duer_0_1251	cntv古装剧场
CNTV母婴健康	duer_0_1252	cntv母婴健康
CNTV军事	duer_0_1253	cntv军事
CNTV地理	duer_0_1254	cntv地理
CNTV高网	duer_0_1255	cntv高网
CNTV精选	duer_0_1256	cntv精选
CNTV台球	duer_0_1257	cntv台球
CNTV武侠剧场	duer_0_1258	cntv武侠剧场
CNTV美人	duer_0_1259	cntv美人
CNTV鉴赏	duer_0_1260	cntv鉴赏
CNTV星影	duer_0_1261	cntv星影
CNTV早教	duer_0_1262	cntv早教
CNTV家庭影院	duer_0_1263	cntv家庭影院
CNTV好学生	duer_0_1264	cntv好学生
CNTV喜剧影院	duer_0_1265	cntv喜剧影院
CNTV动作影院	duer_0_1266	cntv动作影院
CNTV墨宝	duer_0_1267	cntv墨宝
CNTV光影	duer_0_1268	cntv光影
CNTV戏曲	duer_0_1269	cntv戏曲
CNTV爱生活	duer_0_1270	cntv爱生活
CNTV解密	duer_0_1271	cntv解密/cntv揭秘
CNTV武术	duer_0_1272	cntv武术
CNTV美妆	duer_0_1273	cntv美妆
CNTV动画	duer_0_1274	cntv动画
唐山党员教育	duer_0_1275	唐山党员教育/唐山电视台党员教育频道/唐山电视台党员教育
汉中一套	duer_0_1276	汉中一套/汉中一/汉中电视台新闻综合频道/汉中电视台新闻综合/汉中一台
汉中二套	duer_0_1277	汉中二套/汉中二/汉中电视台经济科教频道/汉中电视台经济科教/汉中二台
汉中三套	duer_0_1278	汉中三套/汉中三/汉中电视台文化旅游频道/汉中电视台文化旅游/汉中三台
汉中四套	duer_0_1279	汉中四套/汉中四/汉中电视台四套/汉中电视台四/汉中四台
文山新闻综合频道	duer_0_1280	文山新闻综合频道/文山新闻综合/文山电视台新闻综合频道/文山电视台新闻综合/文山新闻台/文山新闻/文山综合台/文山综合
文山公共频道	duer_0_1281	文山公共频道/文山公共/文山电视台公共频道/文山电视台公共/文山公共台
凉山彝语频道	duer_0_1282	凉山彝语频道/凉山彝语/凉山电视台彝语频道/凉山电视台彝语/凉山彝语台
初中一年级	duer_0_1283	初中一年级
初中二年级	duer_0_1284	初中二年级
初中三年级	duer_0_1285	初中三年级
绥化影视频道	duer_0_1286	绥化影视频道/绥化影视/绥化电视台影视频道/绥化电视台影视/绥化影视台
绥化图文频道	duer_0_1287	绥化图文频道/绥化图文/绥化电视台图文频道/绥化电视台图文/绥化图文台
睛彩昆明	duer_0_1288	睛彩昆明
安徽骄阳剧场频道	duer_0_1289	安徽骄阳剧场频道/安徽骄阳剧场
睛彩太原	duer_0_1290	睛彩太原
熊猫频道	duer_0_1291	熊猫频道/熊猫/cntv熊猫频道/cntv熊猫
亳州都市频道	duer_0_1292	亳州都市频道/亳州都市/亳州电视台都市频道/亳州电视台都市
QTV-李沧	duer_0_1293	qtv李沧/青岛李沧台/青岛李沧
随州都市频道	duer_0_1294	随州都市频道/随州都市/随州电视台都市频道/随州电视台都市
娄底都市频道	duer_0_1295	娄底都市频道/娄底都市/娄底电视台都市频道/娄底电视台都市/娄底都市台
达州综合频道	duer_0_1296	达州综合频道/达州综合/达州电视台新闻综合频道/达州电视台新闻综合/达州新闻综合频道/达州新闻综合/达州新闻综合台/达州新闻台/达州新闻
达州公共频道	duer_0_1297	达州公共频道/达州公共/达州电视台公共频道/达州电视台公共/达州公共台
达州城市公众	duer_0_1298	达州城市公众/达州电视台城市公众频道/达州电视台城市公众/达州城市台/达州城市
泰兴生活频道	duer_0_1299	泰兴生活频道/泰兴生活/泰兴电视台生活频道/泰兴电视台生活
泰兴综合频道	duer_0_1300	泰兴综合频道/泰兴综合/泰兴电视台综合频道/泰兴电视台综合
泰兴影视频道	duer_0_1301	泰兴影视频道/泰兴影视/泰兴电视台影视频道/泰兴电视台影视
泰兴图文频道	duer_0_1302	泰兴图文频道/泰兴图文/泰兴电视台图文频道/泰兴电视台图文
名师公开课	duer_0_1303	名师公开课
热播影院	duer_0_1304	热播影院
中国联通特约	duer_0_1305	中国联通特约/中国联通特约频道
I家TV	duer_0_1306	i家tv/爱家tv
辽阳图文1	duer_0_1307	辽阳图文1/辽阳电视台图文信息频道/辽阳电视台图文信息/辽阳图文信息频道/辽阳图文信息/辽阳图文信息台
辽阳图文2	duer_0_1308	辽阳图文2/辽阳电视台信息图文频道/辽阳电视台信息图文/辽阳信息图文频道/辽阳信息图文/辽阳信息台/辽阳信息/辽阳图文台/辽阳图文
移动戏曲	duer_0_1309	移动戏曲/河南电视台移动戏曲频道/河南电视台移动戏曲
巴彦淖尔-1	duer_0_1310	巴彦淖尔1/巴彦淖尔一台/巴彦淖尔一
巴彦淖尔-2	duer_0_1311	巴彦淖尔2/巴彦淖尔二台/巴彦淖尔二
巴彦淖尔-3	duer_0_1312	巴彦淖尔3/巴彦淖尔三台/巴彦淖尔三
大众生活频道	duer_0_1313	大众生活频道/大众生活/cctvip电视大众生活频道/cctvip电视大众生活/iptv大众生活
白山一套	duer_0_1314	白山一套/白山一/白山一台
白山二套	duer_0_1315	白山二套/白山二/白山二台
本溪图文	duer_0_1316	本溪图文
本溪导视	duer_0_1317	本溪导视
邯郸电影频道	duer_0_1318	邯郸电影频道/邯郸电影/邯郸电视台电影频道/邯郸电视台电影/邯郸电影台
互动电视指南	duer_0_1319	互动电视指南/互动电视操作指南频道/互动电视操作指南
业务宣传频道	duer_0_1320	业务宣传频道/业务宣传/四川广电业务宣传频道/四川广电业务宣传
省会新闻录播	duer_0_1321	省会新闻录播/石家庄电视台新闻录播
北仑影视文化	duer_0_1322	北仑影视文化/北仑电视台影视文化频道/北仑电视台影视文化
黄冈都市频道	duer_0_1323	黄冈都市频道/黄冈都市/黄冈电视台都市频道/黄冈电视台都市
新剧跟播	duer_0_1324	新剧跟播
鹤岗农业少儿	duer_0_1325	鹤岗农业少儿/鹤岗电视台农业少儿频道/鹤岗电视台农业少儿
信阳图文信息	duer_0_1326	信阳图文信息/信阳电视台图文信息频道/信阳电视台图文信息
信阳党建农业	duer_0_1327	信阳党建农业/信阳电视台党建农业频道/信阳电视台党建农业
信阳电视剧	duer_0_1328	信阳电视剧/信阳电视台电视剧频道/信阳电视台电视剧
信阳浉河频道	duer_0_1329	信阳浉河频道/信阳浉河/信阳电视台浉河频道/信阳电视台浉河
三门峡教育频道	duer_0_1330	三门峡教育频道/三门峡教育/三门峡电视台教育频道/三门峡电视台教育
三门峡图文频道	duer_0_1331	三门峡图文频道/三门峡图文/三门峡电视台图文信息频道/三门峡电视台图文信息/三门峡图文信息频道/三门峡图文信息
娄底生活频道	duer_0_1332	娄底生活频道/娄底生活/娄底电视台生活频道/娄底电视台生活
强片剧场频道	duer_0_1333	强片剧场频道/强片剧场/iptv强片剧场频道/iptv强片剧场
剧集天地频道	duer_0_1334	剧集天地频道/剧集天地/iptv剧集天地频道/iptv剧集天地
综艺时空频道	duer_0_1335	综艺时空频道/综艺时空/iptv综艺时空频道/iptv综艺时空
华语片场频道	duer_0_1336	华语片场频道/华语片场/iptv华语片场频道/iptv华语片场
经典剧场频道	duer_0_1337	经典剧场频道/经典剧场/iptv经典剧场频道/iptv经典剧场/iptv经典热剧
资讯-文化	duer_0_1338	资讯文化/资讯文化共享
资讯-本地	duer_0_1339	资讯本地/资讯本地文化
资讯-国际旅游	duer_0_1340	资讯国际旅游/资讯国际旅游岛
海南导视	duer_0_1341	海南导视/海南有线导视
金华都市·农村	duer_0_1342	金华都市·农村/金华电视台都市·农村频道/金华电视台都市·农村
金华图文频道	duer_0_1343	金华图文频道/金华图文/金华电视台图文频道/金华电视台图文
乐天高清动漫	duer_0_1344	乐天高清动漫/乐天高清动漫频道/乐天高清少儿/乐天动漫高清
春城视窗	duer_0_1345	春城视窗
昆广导视	duer_0_1346	昆广导视/昆广网络导视
衡水影视频道	duer_0_1347	衡水影视频道/衡水影视/衡水电视台影视娱乐频道/衡水电视台影视娱乐/衡水影视娱乐频道/衡水影视娱乐
营口图文频道	duer_0_1348	营口图文频道/营口图文/营口电视台图文频道/营口电视台图文
海看热播	duer_0_1349	海看热播
海看教育	duer_0_1350	海看教育
海看演艺	duer_0_1351	海看演艺
海看健康	duer_0_1352	海看健康
海看少儿	duer_0_1353	海看少儿
海看剧场	duer_0_1354	海看剧场
海看大片	duer_0_1355	海看大片
三农频道	duer_0_1356	三农频道/三农
超级女声频道	duer_0_1357	超级女声频道/超级女声/2016超级女声频道/2016超级女声
超级院线频道	duer_0_1358	超级院线频道/超级院线
超级动画频道	duer_0_1359	超级动画频道/超级动画
IPTV社会纪实	duer_0_1360	iptv社会纪实
CNTV国学	duer_0_1361	cntv国学
看新闻吧	duer_0_1362	看新闻吧
体坛风云	duer_0_1363	体坛风云
全纪录	duer_0_1364	全纪录
搏击俱乐部	duer_0_1365	搏击俱乐部
游戏达人	duer_0_1366	游戏达人
火爆片场	duer_0_1367	火爆片场
生活剧场	duer_0_1368	生活剧场
金庸武侠	duer_0_1369	金庸武侠
超炫动漫	duer_0_1370	超炫动漫
娱乐秀场	duer_0_1371	娱乐秀场
随音听乐	duer_0_1372	随音听乐
凤凰天下	duer_0_1373	凤凰天下
寰宇纪实	duer_0_1374	寰宇纪实
史海钩沉	duer_0_1375	史海钩沉
谈股论金	duer_0_1376	谈股论金
养生	duer_0_1377	养生
举案说法	duer_0_1378	举案说法
综艺节目1	duer_0_1379	综艺节目1/看天下精选
芒果乐搜	duer_0_1380	芒果乐搜
精品院线频道	duer_0_1381	精品院线频道/精品院线
少儿综艺频道	duer_0_1382	少儿综艺频道/少儿综艺
文化旅游频道	duer_0_1383	文化旅游频道/文化旅游
老年生活频道	duer_0_1384	老年生活频道/老年生活
中原财经频道	duer_0_1385	中原财经频道/中原财经
高清纪实HD	duer_0_1386	高清纪实hd
亚洲剧场HD	duer_0_1387	亚洲剧场hd
网球	duer_0_1388	网球/超级体育
IPTV高网	duer_0_1389	iptv高网
熊猫新闻频道	duer_0_1390	熊猫新闻频道/熊猫新闻
广州花城频道	duer_0_1391	广州花城频道/广州花城/广州电视台花城频道/广州电视台花城
淘Baby	duer_0_1392	淘baby
淘剧场	duer_0_1393	淘剧场
大健康	duer_0_1394	大健康
宜春指南频道	duer_0_1395	宜春指南频道/宜春指南/宜春电视台指南频道/宜春电视台指南
国学与家道频道	duer_0_1396	国学与家道频道/国学与家道/东海电视台国学与家道频道/东海电视台国学与家道
人文地理频道	duer_0_1397	人文地理频道/人文地理
香香美食频道	duer_0_1398	香香美食频道/香香美食
双升英雄会频道	duer_0_1399	双升英雄会频道/双升英雄会
电竞世界	duer_0_1400	电竞世界/电竞世界频道/游戏电竞
葫芦岛导视1	duer_0_1401	葫芦岛导视1
葫芦岛导视2	duer_0_1402	葫芦岛导视2
葫芦岛导视3	duer_0_1403	葫芦岛导视3
遵义76电影频道	duer_0_1404	遵义76电影频道/遵义76电影
调解剧场频道	duer_0_1405	调解剧场频道/调解剧场
梨园在线频道	duer_0_1406	梨园在线频道/梨园在线
玉溪公共频道	duer_0_1407	玉溪公共频道/玉溪公共/玉溪电视台公共频道/玉溪电视台公共/玉溪二台/玉溪二
林州影视综艺	duer_0_1408	林州影视综艺/林州电视台影视综艺频道/林州电视台影视综艺
大爱四川频道	duer_0_1409	大爱四川频道/大爱四川
自然传奇	duer_0_1410	自然传奇
现代房产频道	duer_0_1411	现代房产频道/现代房产
家庭消费频道	duer_0_1412	家庭消费频道/家庭消费
伊犁一套	duer_0_1413	伊犁一套/伊犁一/伊犁电视台汉语新闻综合频道/伊犁电视台汉语新闻综合
伊犁二套	duer_0_1414	伊犁二套/伊犁二/伊犁电视台哈语新闻综合频道/伊犁电视台哈语新闻综合
伊犁三套	duer_0_1415	伊犁三套/伊犁三/伊犁电视台维语新闻综合频道/伊犁电视台维语新闻综合
伊犁四套	duer_0_1416	伊犁四套/伊犁四/伊犁电视台经济频道/伊犁电视台经济
伊犁五套	duer_0_1417	伊犁五套/伊犁五/伊犁电视台生活娱乐频道/伊犁电视台生活娱乐
海看生活	duer_0_1418	海看生活
NewTV完美游戏	duer_0_1420	newtv完美游戏
NewTV动画王国	duer_0_1421	newtv动画王国
NewTV精品纪录	duer_0_1422	newtv精品纪录
舞蹈视界	duer_0_1430	舞蹈视界
IPTV都市剧场	duer_0_1431	iptv都市剧场
电影天地	duer_0_1432	电影天地
卡通动画	duer_0_1433	卡通动画
金色童年	duer_0_1434	金色童年
风云体育	duer_0_1435	风云体育
钓鱼生活	duer_0_1436	钓鱼生活
优视教育	duer_0_1437	优视教育
时尚音乐	duer_0_1438	时尚音乐
IPTV第一剧场	duer_0_1439	iptv第一剧场
经典影视	duer_0_1440	经典影视
热播剧场	duer_0_1441	热播剧场
扬州旅游频道	duer_0_1442	扬州旅游频道/扬州旅游
NewTV精品大剧	duer_0_1443	newtv精品大剧
NewTV精品电影	duer_0_1444	newtv精品电影
NewTV精品体育	duer_0_1445	newtv精品体育
NewTV爱情喜剧	duer_0_1446	newtv爱情喜剧
NewTV古装剧场	duer_0_1447	newtv古装剧场
NewTV军旅剧场	duer_0_1448	newtv军旅剧场
NewTV海外剧场	duer_0_1449	newtv海外剧场
NewTV家庭剧场	duer_0_1450	newtv家庭剧场
NewTV动作电影	duer_0_1451	newtv动作电影
家庭影院	duer_0_1452	家庭影院
涟水综合频道	duer_0_1453	涟水综合频道/涟水综合/涟水县新闻综合频道/涟水县新闻综合
金湖综合频道	duer_0_1454	金湖综合频道/金湖综合/金湖县新闻综合频道/金湖县新闻综合
靖江社会法治	duer_0_1455	靖江社会法治
兴化新闻综合	duer_0_1456	兴化新闻综合/兴化电视台新闻综合频道/兴化电视台新闻综合
无锡精品	duer_0_1457	无锡精品/无锡精品频道
响水新闻综合	duer_0_1458	响水新闻综合/响水电视台新闻综合频道/响水电视台新闻综合
阜宁新闻综合	duer_0_1459	阜宁新闻综合/阜宁新闻综合频道
建湖新闻综合	duer_0_1460	建湖新闻综合/建湖新闻综合频道
东台新闻综合	duer_0_1461	东台新闻综合
扬中新闻综合	duer_0_1462	扬中新闻综合/扬中新闻综合频道
句容新闻综合	duer_0_1463	句容新闻综合/句容新闻综合频道
灌南新闻综合	duer_0_1464	灌南新闻综合/灌南电视台新闻综合频道/灌南电视台新闻综合
新沂新闻综合	duer_0_1465	新沂新闻综合/新沂新闻综合频道
睢宁新闻综合	duer_0_1466	睢宁新闻综合/睢宁新闻综合频道
泗洪新闻综合	duer_0_1467	泗洪新闻综合/泗洪电视台新闻综合频道/泗洪电视台新闻综合
泗阳新闻综合	duer_0_1468	泗阳新闻综合/泗阳电视台新闻综合频道/泗阳电视台新闻综合
TVB音乐台	duer_0_1469	tvb音乐台/tvb音乐/tvb无线音乐台/tvb无线音乐/无线音乐台/无线音乐
now财经台	duer_0_1470	now财经台/now财经
资讯卫视	duer_0_1471	资讯卫视/香港资讯卫视
好莱坞电影频道	duer_0_1473	好莱坞电影频道/好莱坞电影/好莱坞电影台/hollywood/好莱坞/中文好莱坞电影频道/中文好莱坞电影/山东好莱坞电影频道/山东好莱坞电影
Eurosportnews	duer_0_1477	eurosportnews/欧洲体育新闻频道/欧洲体育新闻/欧亚体育/欧洲体育新闻台/欧亚体育新闻
DogTV	duer_0_1478	dogtv
天津国际频道	duer_0_1479	天津国际频道/天津国际/天津电视台国际频道/天津电视台国际
卫视体育台	duer_0_1484	卫视体育台/卫视体育/星空体育/星空体育台/star sport/star sports/star
卫视体育台2	duer_0_1485	卫视体育台2
江苏乐享购物	duer_1_0	江苏乐享购物
河南法治	duer_1_1	河南法治
河南国学	duer_1_2	河南国学
气象頻道	duer_1_3	气象頻道
靓装频道	duer_1_4	靓装频道/靓装
CETV早教	duer_1_5	cetv早教
4K导视频道	duer_1_6	4k导视频道/4k导视
CBN电视剧频道	duer_1_7	cbn电视剧频道/cbn电视剧
CBN电影频道	duer_1_8	cbn电影频道/cbn电影
CBN记录频道	duer_1_9	cbn记录频道/cbn记录
CBN综艺频道	duer_1_10	cbn综艺频道/cbn综艺
CBN教育频道	duer_1_11	cbn教育频道/cbn教育
象棋	duer_1_12	象棋
第一财经高清	duer_2_0	第一财经hd/第一财经高清
上视电视剧频道高清	duer_2_1	上视电视剧频道高清/上视电视剧频道hd/上视电视剧hd/上视电视剧高清
上视纪实频道高清	duer_2_2	上视纪实频道高清/上视纪实频道hd/上视纪实hd/上视纪实高清
上视新闻频道高清	duer_2_3	上视新闻频道高清/上视新闻频道hd/上视新闻hd/上视新闻高清
上视娱乐频道高清	duer_2_4	上视娱乐频道高清/上视娱乐频道hd/上视娱乐hd/上视娱乐高清
五星体育频道高清	duer_2_5	五星体育频道高清/五星体育频道hd/五星体育hd/五星体育高清
CCTV5+高清	duer_3_0	CCTV5+高清
DOX4K	duer_3_1	DOX4K
中国国际广播	duer_3_2	中国国际广播
中央体育赛事	duer_3_3	中央体育赛事
乐宅影视	duer_3_4	乐宅影视
亚洲剧场	duer_3_5	亚洲剧场
动作电影	duer_3_6	动作电影
动感影视	duer_3_7	动感影视
北戴河	duer_3_8	北戴河
唐山信息	duer_3_9	唐山信息
唐山少儿科教	duer_3_10	唐山少儿科教
唐山新闻综合	duer_3_11	唐山新闻综合/唐山综合
唐山生活服务	duer_3_12	唐山生活服务
唐钢电视	duer_3_13	唐钢电视
奥运之声	duer_3_14	奥运之声
山海关	duer_3_15	山海关
文艺之声	duer_3_16	文艺之声
时尚娱乐	duer_3_17	时尚娱乐
杂技世界	duer_3_18	杂技世界
欧美剧场	duer_3_19	欧美剧场
民乐	duer_3_20	民乐
民族之声	duer_3_21	民族之声
沧州导视	duer_3_22	沧州导视
河北交通广播	duer_3_23	河北交通广播
河北农村广播	duer_3_24	河北农村广播
河北导视	duer_3_25	河北导视
河北政务信息	duer_3_26	河北政务信息
河北文艺广播	duer_3_27	河北文艺广播
河北新闻广播	duer_3_28	河北新闻广播
河北旅游广播	duer_3_29	河北旅游广播
河北生活广播	duer_3_30	河北生活广播
河北经济广播	duer_3_31	河北经济广播
河北音乐广播	duer_3_32	河北音乐广播
海南旅游	duer_3_33	海南旅游
环球影视	duer_3_34	环球影视
环球资讯	duer_3_35	环球资讯
秦皇岛公共	duer_3_36	秦皇岛公共
纪实频道	duer_3_37	纪实频道
视尚影院	duer_3_38	视尚影院
都市之声	duer_3_39	都市之声
btv文艺高清	duer_4_0	btv文艺高清
金鹰纪实高清	duer_4_1	金鹰纪实高清
上海纪实高清	duer_4_2	上海纪实高清
爵士音乐	duer_4_3	爵士音乐
btv影视高清	duer_4_4	btv影视高清
海淀高清	duer_4_5	海淀高清
奕坛春秋	duer_4_6	奕坛春秋
btv新闻高清	duer_4_7	btv新闻高清
中国教育电视台高清1	duer_4_8	中国教育电视台高清1
环球购物高清	duer_4_9	环球购物高清
歌华导视高清	duer_4_10	歌华导视高清
戏曲	duer_4_11	戏曲
华娱卫视	duer_5_0	华娱卫视频道/华娱电视台/华娱卫视台/华娱卫视
香港亚洲电视本港台	duer_5_1	亚洲电视本港台/本港台/亚视本港台/亚洲台/亚洲电视台/香港本港/亚视本港/香港亚洲电视本港台
香港亚洲电视国际台	duer_5_2	亚洲电视国际台/国际台/香港国际/亚视国际/香港亚洲电视国际台
韩剧频道	duer_5_3	韩剧频道
情感剧场	duer_5_4	情感剧场
甜果高清影院	duer_5_5	甜果高清影院
甜果高清少儿	duer_5_6	甜果高清少儿
now tv	duer_5_7	nowtv/NOW电视台/NOWtv/NOW电视
看看新闻	duer_5_8	看看新闻
天途高清军事	duer_5_9	高清军事/天途高清军事
港剧精选频道	duer_5_10	港剧精选频道
武汉欧美影院频道	duer_5_11	武汉欧美影院/武汉欧美影院频道
武汉情感剧场频道	duer_5_12	武汉情感剧场/武汉情感剧场频道
亚洲精选	duer_5_13	亚洲精选
芒果美食	duer_5_14	芒果美食
芒果演艺	duer_5_15	芒果演艺
芒果曲艺	duer_5_16	芒果曲艺
沙发院线四厅	duer_5_17	沙发院线四厅
沙发院线五厅	duer_5_18	沙发院线五厅
珠江一线	duer_5_19	珠江一线
天途环球影院	duer_5_20	天途环球影院
甜果粤港荟	duer_5_21	甜果粤港荟
华数日韩剧场	duer_5_22	日韩剧场/华数日韩剧场
华数历史剧场	duer_5_23	历史剧场/华数历史剧场
青海党建	duer_5_24	青海党建
本溪剧场1	duer_5_25	本溪剧场1
本溪剧场2	duer_5_26	本溪剧场2
威海电视台综艺频道	duer_5_27	威海综艺频道/威海电视台综艺频道
甜果高清综艺	duer_5_28	甜果高清综艺
城视增城	duer_5_29	城视增城
好莱坞影院	duer_5_30	hmc/好莱坞影院hmc1/好莱坞影院
东海综艺生活	duer_5_31	东海综艺生活
kbs2	duer_5_32	kbs2/kbs2 tv
国家地理野生频道	duer_5_33	国家地理野生频道/national geographic wild/ngw/国家地理野生/国家地理高画质野生频道
ftv	duer_5_34	ftv
商河新闻频道	duer_5_35	商河新闻频道
商河综艺频道	duer_5_36	商河综艺频道
环翠电视台	duer_5_37	环翠台/环翠电视台
萍乡电视台教育频道	duer_5_38	萍乡教育频道/萍乡教育台/萍乡电视台教育频道
许昌电视台晴彩频道	duer_5_39	许昌晴彩频道/许昌电视台晴彩频道
nv高清影院	duer_5_40	nv高清影院
nv高清剧场	duer_5_41	nv高清剧场
广铁有线	duer_5_42	广铁有线
肥城远教	duer_5_43	肥城远教
蕲春有线	duer_5_44	蕲春有线
蕲春互动	duer_5_45	蕲春互动/蕲春互动台
蕲春图文资讯	duer_5_46	蕲春图文资讯/蕲春图文台
蕲春生活频道	duer_5_47	蕲春生活频道/蕲春生活台
潍坊都市	duer_6_0	潍坊都市
辽宁移动电视	duer_6_1	辽宁移动电视
熊猫频道高清	duer_6_2	熊猫频道高清
山东国际	duer_6_3	山东国际
辽宁宜家购物	duer_6_4	辽宁宜家购物
商业频道	duer_6_5	商业频道
广东体育高清	duer_6_6	广东体育高清
全省新闻频道	duer_6_7	全省新闻频道
体育频道+高清	duer_6_8	体育频道+高清
亚洲影视高清	duer_6_9	亚洲影视高清
欧美影院高清	duer_6_10	欧美影院高清
精品剧场高清	duer_6_11	精品剧场高清
探索纪事高清	duer_6_12	探索纪事高清
风尚音乐高清	duer_6_13	风尚音乐高清
dox新知高清	duer_6_14	dox新知高清
dox新艺高清	duer_6_15	dox新艺高清
dox韩流高清	duer_6_16	dox韩流高清
dox怡家高清	duer_6_17	dox怡家高清
dox英伦高清	duer_6_18	dox英伦高清
求索记录高清	duer_6_19	求索记录高清
大麦频道	duer_6_20	大麦频道
东方大剧院	duer_6_21	东方大剧院
大片连映	duer_6_22	大片连映
喋血剧场	duer_6_23	喋血剧场
热剧连播	duer_6_24	热剧连播
hrb娱乐	duer_6_25	hrb娱乐
hrb影视	duer_6_26	hrb影视
hrb生活	duer_6_27	hrb生活
体育频道高清	duer_6_28	体育频道高清
长岛综合频道	duer_7_0	长岛综合频道
4k畅享	duer_7_1	4k畅享
4k畅享高清	duer_7_2	4k畅享高清
4k欣赏	duer_7_3	4k欣赏
4k欣赏高清	duer_7_4	4k欣赏高清
ytv4芝罘	duer_7_5	ytv4芝罘
ytv公共	duer_7_6	ytv公共
ytv生活	duer_7_7	ytv生活
ytv新闻综合	duer_7_8	ytv新闻综合
ytv影视	duer_7_9	ytv影视
宝岛怡家高清	duer_7_10	宝岛怡家高清
长岛党建频道	duer_7_11	长岛党建频道
长岛影视频道	duer_7_12	长岛影视频道
畅享导视	duer_7_13	畅享导视
党员远程教育	duer_7_14	党员远程教育
东营新闻	duer_7_15	东营新闻
杜比5.1高清	duer_7_16	杜比5.1高清/杜比51高清/杜比五一高清
福山新闻综合	duer_7_17	福山新闻综合
福山影视咨询	duer_7_18	福山影视咨询
高清剧场高清	duer_7_19	高清剧场高清
高清探索高清	duer_7_20	高清探索高清
高清影院高清	duer_7_21	高清影院高清
高新区综合频道	duer_7_22	高新区综合频道
故事	duer_7_23	故事
贵州卫视高清	duer_7_24	贵州卫视高清
环球新艺高清	duer_7_25	环球新艺高清
环宇电影高清	duer_7_26	环宇电影高清
济南新闻高清	duer_7_27	济南新闻高清
济南影视高清	duer_7_28	济南影视高清
济宁新闻	duer_7_29	济宁新闻
家有购物高清	duer_7_30	家有购物高清
精彩影视高清	duer_7_31	精彩影视高清
开发区党建频道	duer_7_32	开发区党建频道
开发区新闻综合	duer_7_33	开发区新闻综合
快乐购高清	duer_7_34	快乐购高清
莱山综合频道	duer_7_35	莱山综合频道
莱州潮流购物	duer_7_36	莱州潮流购物
莱州党建	duer_7_37	莱州党建
莱州广电剧场	duer_7_38	莱州广电剧场
莱州广电业务推介	duer_7_39	莱州广电业务推介
莱州广电影院	duer_7_40	莱州广电影院
莱州生活娱乐	duer_7_41	莱州生活娱乐
临沂新闻	duer_7_42	临沂新闻
龙口党建生活	duer_7_43	龙口党建生活
龙口图文	duer_7_44	龙口图文
龙口综合	duer_7_45	龙口综合
美食之旅高清	duer_7_46	美食之旅高清
欧美电影高清	duer_7_47	欧美电影高清
蓬莱党建频道	duer_7_48	蓬莱党建频道
蓬莱图文频道	duer_7_49	蓬莱图文频道
蓬莱新闻	duer_7_50	蓬莱新闻
蓬莱综艺	duer_7_51	蓬莱综艺
栖霞导视频道	duer_7_52	栖霞导视频道
栖霞农科	duer_7_53	栖霞农科
栖霞新闻	duer_7_54	栖霞新闻
齐鲁石化	duer_7_55	齐鲁石化
齐鲁石化高清	duer_7_56	齐鲁石化高清
求索动物高清	duer_7_57	求索动物高清
求索纪录高清	duer_7_58	求索纪录高清
求索科学高清	duer_7_59	求索科学高清
求索生活高清	duer_7_60	求索生活高清
热播美剧高清	duer_7_61	热播美剧高清
山铝新闻	duer_7_62	山铝新闻
少儿动漫高清	duer_7_63	少儿动漫高清
生活频道	duer_7_64	生活频道
文艺	duer_7_65	文艺
下周导视高清	duer_7_66	下周导视高清
现代农业	duer_7_67	现代农业
新闻汇播	duer_7_68	新闻汇播
新闻汇播oc	duer_7_69	新闻汇播oc
新闻荟萃高清	duer_7_70	新闻荟萃高清
雅趣综艺高清	duer_7_71	雅趣综艺高清
亚洲电影高清	duer_7_72	亚洲电影高清
烟台导视高清	duer_7_73	烟台导视高清
烟台商务1	duer_7_74	烟台商务1/烟台商务一
烟台商务2	duer_7_75	烟台商务2/烟台商务二
烟台休闲娱乐	duer_7_76	烟台休闲娱乐
演唱会高清	duer_7_77	演唱会高清
英超直播高清	duer_7_78	英超直播高清
影像英伦高清	duer_7_79	影像英伦高清
院线电影高清	duer_7_80	院线电影高清
张店图文	duer_7_81	张店图文
招金频道	duer_7_82	招金频道
中矿综艺	duer_7_83	中矿综艺
自然传奇高清	duer_7_84	自然传奇高清
中国交通高清	duer_8_0	中国交通高清
探索纪录高清	duer_8_1	探索纪录高清
中博韩朝放送	duer_8_2	中博韩朝放送
中博纪录频道	duer_8_3	中博纪录频道/中博记录频道/中博记录
央视3d高清	duer_8_4	央视3d高清
循环影院	duer_8_5	循环影院
教育园地	duer_8_6	教育园地
休闲指南	duer_8_7	休闲指南
加密01	duer_8_8	加密01
加密02	duer_8_9	加密02
加密04	duer_8_10	加密04
加密05	duer_8_11	加密05
加密06	duer_8_12	加密06
加密07	duer_8_13	加密07
加密08	duer_8_14	加密08
恩施新闻	duer_9_0	恩施新闻/恩施新闻频道
恩施公共频道	duer_9_1	恩施公共频道/恩施公共
优优购物	duer_10_0	优优购物
欢笑剧场	duer_11_0	欢笑剧场
上海星尚频道高清	duer_12_0	上海星尚频道高清/上海星尚频道hd
上视外语频道高清	duer_12_1	上视外语频道高清/上视外语频道hd
东方电影台高清	duer_12_2	东方电影台高清/东方电影台hd
